Trigger warning: This game deals with violence and suicidal contents.

The Ghost Ship
An Interactive Fiction by "INFORMational Wizards" Release along with a website
Release 1 / Serial number 211120 / Inform 7 build 6M62 (I6/v6.33 lib 6/12N) SD

Total Darkness
You wake up, from an unbearable headache, it is as if you've been through a terrible nightmare. But what is worse is that you seem to have lost a large portion of your memory. It is a strange feeling - names, languages and general knowledge, of these you know still, but you can't remember the most important things at this moment - where the hell are you. 

You open your eyes as the acute headache subsides but you can't see anything. It is the most overwhelming darkness ever - it was not merely the darkness that came out of absence of light, it was much more sinister, almost as if something behind the darkness is watching your every move. You stretch your eyes as wide as possible trying to capture the even dimmest glimmer of light but still nothing but blackness.

You are certain that you're in some kind of a room, the quiet and stale air gives away. Even though you cannot see anything, your other four senses are alright - you can feel the pillow beneath your head and the soft, warm quilt over your body.

>test me
(Testing.)

>[1] examine sign
You can get half-day and full-day sight-seeing tours, and half-day and full-day fishing trips.

>[2] examine glacier
The Malaspina glacier covers much of the nearby slope, and -- beyond it -- an area as large as Rhode Island.

>[3] examine instruments
Knowing what they do is the Captain's job.

>[4] examine windows
They're a bit the worse for wear, but you can still get an impressive view of the glacier through them. There were whales earlier, but they're gone now.

>[5] examine radar
Apparently necessary to avoid the larger icebergs.

>[6] examine radios
With any luck you will not need to radio for help, but it is reassuring that these things are here.

>[7] take the cushions
They're hardly portable.

>[8] take the glacier
That's hardly portable.

* * *

>examine case
Ia dfsdkhfksd.

In the glass case is a collection of fishing rods.

* * *

>examine cabin
You can't see any such thing.

>examine navigational instruments
Knowing what they do is the Captain's job.

>take navigational instruments
They're hardly portable.

>kick navigational instruments
That's not a verb I recognise.

* * *

>look around
Total Darkness
You can't even see your hands!

>look
Cabin
The front of the small cabin is entirely occupied with navigational instruments, a radar display, and radios for calling back to shore. Along each side runs a bench with faded blue vinyl cushions, which can be lifted to reveal the storage space underneath. A glass case against the wall contains several fishing rods.

Scratched windows offer a view of the surrounding bay, and there is a door south to the deck. A sign taped to one wall announces the menu of tours offered by the Yakutat Charter Boat Company.

Ia dfsdkhfksd.

>pick up radio
You can't see any such thing.

>pick up radios
They're hardly portable.

>pick up cushions
They're hardly portable.

>pick up vinyl cushions
They're hardly portable.

>Test me
(Testing.)

>[1] examine sign
You can get half-day and full-day sight-seeing tours, and half-day and full-day fishing trips.

>[2] examine glacier
The Malaspina glacier covers much of the nearby slope, and -- beyond it -- an area as large as Rhode Island.

>[3] examine instruments
Knowing what they do is the Captain's job.

>[4] examine windows
They're a bit the worse for wear, but you can still get an impressive view of the glacier through them. There were whales earlier, but they're gone now.

>[5] examine radar
Apparently necessary to avoid the larger icebergs.

>[6] examine radios
With any luck you will not need to radio for help, but it is reassuring that these things are here.

>[7] take the cushions
They're hardly portable.

>[8] take the glacier
That's hardly portable.

* * *

>look around
Total Darkness
You can't even see your hands!

>get up
You get off the bed.

* * *

>look around pillow
You can't see any such thing.

>look pillow
It is pitch dark, and you can't see a thing.

If this is a room, surely there must be a light switch somewhere.

* * *

>access glass case
You open the glass case.

>reach for the fishing rods
That's not a verb I recognise.

>reach
That's not a verb I recognise.

>feel about
You can't see any such thing.

* * *

>grope for the glass case
In the glass case is a collection of fishing rods.

* * *

>examine table
On the table is a Necronomicon.

* * *

>check table
1234

On the table is a Necronomicon.

>read
What do you want to read?

>read Necronomicon
You see nothing special about the Necronomicon.

>read glass case
In the glass case is a collection of fishing rods.

* * *

>read cabin
You can't see any such thing.

>read instruments
Knowing what they do is the Captain's job.

>reading instruments
You read through the logs, but found nothing strange, eveything seems normal. Judging by the last page, the HMS Alert was sailing through the planned route across the atlantis, and no deviation was found whatsoever.

* * *

>read cabin
You can't see any such thing.

>read room
You can't see any such thing.

>read book
You can't see any such thing.

>read bay
You can't see any such thing.

>read table
You can't see any such thing.

>read glass case
You can't see any such thing.

* * *

>read cabin
You can't see any such thing.

>read instruments
You read through the logs, but found nothing strange, eveything seems normal. Judging by the last page, the HMS Alert was sailing through the planned route across the atlantis, and no deviation was found whatsoever.

* * *

>look through necronomicon
You find nothing of interest.

* * *

>look through glass case
In the glass case is a collection of fishing rods.

* * *

>look through the captain's log
You find nothing of interest.

* * *

>consulting log about route
That's not a verb I recognise.

>consult log about route
wow.

* * *

>read table
1234

* * *

>read log
You skim through the logs, but found nothing worth noting, eveything seems to be normal. Judging by the last page, the HMS Alert was sailing alone the planned route across the Atlantic Ocean, "If nothing goes wrong from now on, we would be in America within a week",  Captain Miller wrote.

>read log
You have read all the logs already.

>read log
You skim through the logs, but found nothing worth noting, eveything seems to be normal. Judging by the last page, the HMS Alert was sailing alone the planned route across the Atlantic Ocean, "If nothing goes wrong from now on, we would be in America within a week",  Captain Miller wrote.

* * *

>take captain's log
Taken.

>inventory
You are carrying:
  a Captain's Log

* * *

>take apple
You can't see any such thing.

>take apples
Taken.

* * *

>take apples
Taken.

>take log
You're carrying too many things already.

>drop apples
Dropped.

>look around
You can't see any such thing.

>put the log on the table
(first taking the Captain's Log)
You put the Captain's Log on the table.

>put the log on apples
(first taking the Captain's Log)
Putting things on two apples would achieve nothing.

>see
That's not a verb I recognise.

>list of items
That's not a verb I recognise.

>take apples
You're carrying too many things already.

>eat apples
That's plainly inedible.

* * *

>eat apple
(first taking the apple)
You eat the apple. Not bad.

>look around
You can't see any such thing.

* * *

>examine welding unit
An old oxyacetylene welding unit, although it's been sitting there for years, judging by the pressure indicator, it is still usable.

>move welding unit
It is fixed in place.

* * *

>take welding unit
Taken.

>move welding unit
Nothing obvious happens.

>drop welding unit
Dropped.

* * *

>go to the hallway
That noun did not make sense in this context.

>hallway
That's not a verb I recognise.

>move to hallway
You can't see any such thing.

>move to steel door
You can't see any such thing.

>steel door
That's not a verb I recognise.

* * *

>examine door
You see nothing special about the steel door.

>go to hallway
That noun did not make sense in this context.

* * *

>hallway
That's not a verb I recognise.

>examine hallway
You can't see any such thing.

>go through steel door
(first opening the steel door)

hallway
You can see a steel door here.

* * *

>?
That's not a verb I recognise.

* * *

>open steel door
TODO - Before Hallway Intro.

>go to hallway
You walk to the hallway.

hallway
You can see a steel door here.

>go to the hallway
That noun did not make sense in this context.

>move to the hallway
You can't see any such thing.

>move to hallway
You can't see any such thing.

>go through steel door
hallway
You can see a steel door here.

>go to cabin
That noun did not make sense in this context.

>go through steel door
Cabin
The front of the small cabin is entirely occupied with navigational instruments, a radar display, and radios for calling back to shore. Along each side runs a bench with faded blue vinyl cushions, which can be lifted to reveal the storage space underneath. A glass case against the wall contains several fishing rods.

Scratched windows offer a view of the surrounding bay, and there is a door south to the deck. A sign taped to one wall announces the menu of tours offered by the Yakutat Charter Boat Company.

Mist coils around your feet, thick as a blanket. You cannot even see the ground you walk upon.

* * *

>go to hallway
You walk to the hallway.

hallway
You can see a steel door here.

>move to hallway
You can't see any such thing.

* * *

>open steel door
TODO - Before Hallway Intro.

>move the welding unit to hallway
You can't see any such thing.

>to the hallway
That's not a verb I recognise.

>move the welding unit through hallway
You can't see any such thing.

>move the welding unit through steel door
You can't see any such thing.

>push the welding unit through steel door
You can't see any such thing.

>push the welding unit
It is fixed in place.

* * *

>go through steel door
Through the window, you make out the hallway.

* * *

>open door
TODO - Before Hallway Intro.

>go to hallway
That noun did not make sense in this context.

* * *

>open door
TODO - Before Hallway Intro.

>push the welding unit to hallway
You can't see any such thing.

>push the welding unit through steel door
You can't see any such thing.

>push the welding unit east
hallway
You can see a steel door here.

>examine welding unit
An old oxyacetylene welding unit, although it's been sitting there for years, judging by the pressure indicator, it is still usable.

>go to cabin
You walk to the Cabin.

Cabin
TODO - Player room intro

On the bench is an apple.

You can also see a steel door, a glass case (closed) (in which is a collection of fishing rods) and a table (on which is a Captain's Log) here.

>go to hallway
You walk to the hallway.

hallway
You can see a steel door and a welding unit here.

* * *

>move to hallway
You walk to the hallway.

hallway
You can see a steel door here.

* * *

>go to void
You can't go that way.

>go to hallway
You can't go that way.

* * *

>cheat
Number: 0, passcode 5706   3958 6792 6328 2922 Game_Clue 0

>dial padlock to 3413
You can't see any such thing.

>turn on light
You switch the light switch on.

Turn pass
Cabin
TODO - Player room intro

You can see a steel door, a table (on which is a Captain's Log), a bed, a bookshelf (in which are some books), a wardrobe (in which is a leather jacket), a closet (closed) (in which is a few cups), a scratched window and a drawer (closed) here.

>dial padlock to 3413
The padlock clicks unlocked.

Turn pass

>open door
TODO - Before Hallway Intro.

Turn pass

* * *

>cheat
Number: 0, passcode 5706   3958 6792 6328 2922 Game_Clue 0

>test a
(Testing.)

>[1] switch on light switch
You switch the light switch on.

Cabin
TODO - Player room intro

You can see a steel door, a table (on which is a few paper), a bed (on which is a pillow), a bookshelf (in which are some books), a wardrobe (in which is a leather jacket), a closet (closed) (in which is a few cups), a scratched window and a desk (on which is a wedding picture) here.

>[2] examine steel door
This is just a typical steel door on a military vessel - heavy and sturdy. You notice there is an old padlock on the hasp. If you want to go out, you'll definitely need to get rid of this padlock.

>[3] open steel door
You cannot force open the door while there's a sturdy padlock holding it in place.

>[4] look under bed
You find the brass key!

>[5] unlock drawer
(with the brass key)
You unlock the drawer.

>[6] open drawer
You open the drawer, revealing a revolver pistol.

>[7] take pistol
An antique revolver pistol lies silently in the drawer. The revolver is a Webley Mk. IV revolver, a memorial medal for a war veteran of a not so distant war.
The moment you see it, you feel something is awakening deep inside your memory, you seem to recall a certain passcode - 6905.

You take the pistol and instinctly hit the break lever, flip the fore-piece forward and look into the cylinder to check how many bullets are left. To your disappointment, it seems there is only one .455 bullet left in the cylinder.

* * *

>cheat
Number: 0, passcode 5706   3958 6792 6328 2922 Game_Clue 0

>cheat
Number: 0, passcode 6167 7550 5508 4291 8515 Game_Clue 3

* * *

>cheat
Number: 0, passcode 5706   3958 6792 6328 2922 Game_Clue 0

>feel myself
Limbs? Check. Legs? Check. Head? Check. Eyes? Check. Apparently your eyes are fine, it's just that the room is too dark.

>cheat
Number: 0, passcode 5706   3958 6792 6328 2922 Game_Clue 0

* * *

>examine instrument
Knowing what they do is the Captain's job.

>examine instrument
Knowing what they do is the Captain's job.

>look instrument
Knowing what they do is the Captain's job.

* * *

>examine instruments
wow

>cheat
Number: 1

>examine instruments
Knowing what they do is the Captain's job.

>cheat
Number: 1

* * *

>cheat
Number: 1

>examine log
You see nothing special about the Captain's Log.

>cheat
Number: 1

* * *

>examine sb
You can't see any such thing.

* * *

>cheat
Number: 4

* * *

>look log
wowCaptain's Log

* * *

>look apple
wowapple

* * *

>look welding unit
An old oxyacetylene welding unit, although it's been sitting there for years, judging by the pressure indicator, it is still usable.

>look log
ouch!

>look welding unit
Shit

* * *

>look unit
not_broken:1 An old oxyacetylene welding unit, although it's been sitting there for years, judging by the pressure indicator, it is still usable.

* * *

>look wardrobe
Print the value of not broken 1 TODO - Wardrobe 

In the wardrobe is a leather jacket.

>look bookshelf
TODO - Bookshelf 

In the bookshelf are some books.

* * *

>look bookshelf
Shit.

In the bookshelf are some books.

>take books
Taken.

>look bookshelf
TODO - Bookshelf

>put books into the bookshelf
You put the books into the bookshelf.

>look bookshelf
TODO - Bookshelf 

In the bookshelf are some books.

>take the captain's log
Taken.

>push the welding unit into the bookshelf
You can't see any such thing.

>look welding unit
An old oxyacetylene welding unit, although it's been sitting there for years, judging by the pressure indicator, it is still usable.

>move the welding unit into the bookshelf
You can't see any such thing.

>move the captain's log to the bookshelf
You can't see any such thing.

>take captain's log
You already have that.

>look
Cabin
TODO - Player room intro

You can see a steel door, a table, a bed, a bookshelf (in which are some books), a wardrobe, a closet, a window and a welding unit here.

* * *

>take leather jacket
Taken.

>wear leather jacket
You put on the leather jacket.

>put leather jacket into the wardrobe
(first taking it off)
You put the leather jacket into the wardrobe.

* * *

>take books
Taken.

>put books inside wardrobe
sb

* * *

>put log into bookshelf
You put Captain's Log into bookshelf

* * *

>look at wardrobe
Print the value of not broken1 TODO - Wardrobe 

In the wardrobe is a leather jacket.

* * *

>take log
Taken.

>put log into bookshelf
You put Captain's Log into the bookshelf

* * *

>take log
Taken.

>put log on the table
You put the Captain's Log on the table.

>examine log
ouch!

>examine welding unit
You can't see any such thing.

>open door
TODO - Before Hallway Intro.

>go to hallway
You walk to the hallway.

hallway
You can see a steel door and a welding unit here.

>examine welding unit
Shit

* * *

>inventory
You are carrying nothing.

>capacity
That's not a verb I recognise.

>inventory capacity
I only understood you as far as wanting to take inventory.

* * *

>examine table
You can't see any such thing.

>go to cabin
You walk to the Cabin.

Cabin
TODO - Player room intro

You can see a steel door, a table (on which is a Captain's Log), a bed, a bookshelf (in which are some books), a wardrobe (in which is a leather jacket), a closet and a window here.

>examine table
TODO - Table 

On the table is a Captain's Log.

* * *

>go to cabin
You walk to the Cabin.

Cabin
TODO - Player room intro

You can see a steel door, a table (on which is a Captain's Log), a bed, a bookshelf (in which are some books), a wardrobe (in which is a leather jacket), a closet and a window here.

>look table
Shit.

On the table is a Captain's Log.

>look bookshelf
TODO - Bookshelf 

In the bookshelf are some books.

* * *

>open steel door
You cannot force open the door while there's a sturdy padlock holding it in place.

Turn pass

* * *

>open drawer
You open the drawer, revealing a revolver pistol.

Turn pass

>take pistol
ouch!

Turn pass

>take pistol
Taken.

Turn pass

* * *

>take pistol
You already have that.

Turn pass

* * *

>examine pistol
A Webley Mk. IV .455 revolver pistol.

Turn pass

>examine pistol
A Webley Mk. IV .455 revolver pistol.

Turn pass

>think about
I only understood you as far as wanting to think.

>think pistol
I only understood you as far as wanting to think.

>open door
You cannot force open the door while there's a sturdy padlock holding it in place.

Turn pass

>go to hallway
You can't go that way.

Turn pass

>go through door
(first opening the steel door)
You cannot force open the door while there's a sturdy padlock holding it in place.

Turn pass

>shoot
That's not a verb I recognise.

* * *

>shoot bed
You walk to the bed.

Turn pass

>shoot bed
You press the trigger but nothing happens, apparently you're out of ammunition.

Turn pass

* * *

>shoot myself
You shoot yourself.

    *** Several days later, a cargo ship found the MV Valiant adrifting with the gulf stream. After repeated hailing with no response, the crew decided to approach the ship and investigate. To the crew's horror, there's not a single soul on board the ship There were no sign of violence, eveything was in pristine state. ***

Would you like to RESTART, RESTORE a saved game, QUIT or UNDO the last command?

* * *

>shoot door
(the steel door)
You shoot the steel door.
You raise the pistol and aim your shot, your hand steady and stable. The bullet blasts forth at sonic speed, hitting the padlock right in the center of mass. An ear-bleeding metallic impact sound and blinding sparks ensue. You see that the padlock is now completely destroyed.

>open door
Congratulations! You've cleared the demo.

>go through door
hallway
You can see a steel door and a welding unit here.

* * *

>open door
Congratulations! You've cleared the demo.

>go to hallway
(the northern hallway)
You walk to the northern hallway.

northern hallway
Typical narrow hallway seen on common naval vessels, the engine room is south of the hallway. North of the hallway is the stairs to the upper deck, but the hatch door is closed.

You can see a steel door here.

>look stairs
You can't see any such thing.

>look stair
You can't see any such thing.

I beg your pardon?

>look door
This is just a typical steel door on a military vessel - heavy and sturdy.

>look stairs
You can't see any such thing.

>look
northern hallway
Typical narrow hallway seen on common naval vessels, the engine room is south of the hallway. North of the hallway is the stairs to the upper deck, but the hatch door is closed.

You can see a steel door here.

>go north
You can't go that way.

>open stairs
You can't see any such thing.

* * *

>shoot door
(the steel door)
You shoot the steel door.
You raise the pistol and aim your shot, your hand steady and stable. The bullet blasts forth at sonic speed, hitting the padlock right in the center of mass. An ear-bleeding metallic impact sound and blinding sparks ensue. You see that the padlock is now completely destroyed.

>move to captain's chamber
You can't go that way.

Turn pass

>go to chamber
You can't go that way.

Turn pass

>go to storage
That noun did not make sense in this context.

* * *

>shoot door
(the steel door)
You shoot the steel door.
You raise the pistol and aim your shot, your hand steady and stable. The bullet blasts forth at sonic speed, hitting the padlock right in the center of mass. An ear-bleeding metallic impact sound and blinding sparks ensue. You see that the padlock is now completely destroyed.

>examine padlock
The padlock cannot stop you now.

Turn pass

>examine the steel door
This is just a typical steel door on a military vessel - heavy and sturdy. You notice there is an old padlock on the hasp. If you want to go out, you'll definitely need to get rid of this padlock.

Turn pass

>examine padlock
You can't see any such thing.

* * *

>examine padlock
The padlock cannot stop you now.

Turn pass

>open door
TODO - Before Hallway Intro.

Turn pass

* * *

>shoot door
(the steel door)
You shoot the steel door.
You raise the pistol and aim your shot, your hand steady and stable. The bullet blasts forth at sonic speed, hitting the padlock right in the center of mass. An ear-bleeding metallic impact sound and blinding sparks ensue. You see that the padlock is now completely destroyed.

>look door
Shit.

* * *

>shoot padlock
Why do you want to shoot the padlock?

>open steel dook
I only understood you as far as wanting to open the steel door.

>open steel door
You cannot force open the door while there's a sturdy padlock holding it in place.

* * *

>shoot padlock
Why do you want to shoot the padlock?

>examine padlock
The padlock cannot stop you now.

* * *

>shoot padlock
Why do you want to shoot the padlock?

>go to hallway
You can't go that way.

>open door
Congratulations! You've cleared the demo.

>go to hallway
You walk to the hallway.

hallway
You can see a steel door, a bunker door and a welding unit here.

>open door
Which do you mean, the steel door or the bunker door?

>push welding unit to cabin
You can't see any such thing.

>push welding unit through door
You can't see any such thing.

>look
hallway
You can see a steel door, a bunker door and a welding unit here.

>push welding unit to steel door
You can't see any such thing.

>move welding unit to door
You can't see any such thing.

>push welding unit to cabin
You can't see any such thing.

>push
What do you want to push?

>push welding unit
Nothing obvious happens.

>push welding unit south
(first opening the bunker door)

Engine room
You can see a bunker door here.

* * *

>go to hallway
You can't go that way.

>go to hallway
You can't go that way.

>open bunker door
That's already open.

>go to hallway
You can't go that way.

>go through door
hallway
You can see a bunker door and a steel door here.

>go to cabin
You walk to the Cabin.

Cabin
Spacious ship cabin for a single sailor. The only thing that deviates from the overall pragmatic design is the refined wooden plate floor. There's a single porthole window on the plain steel wall, its rim is a little bit rusty. Despite scattered scratches, bulges, wear and tear on the wall, the cabin withstood the vicissitudes of time.

You can see a steel door, a table on which is a few paper, a bed, a bookshelf in which are some books, a wardrobe in which is a leather coat, a closet in which is a few cups, a desk with a built-in drawer. On the desk is a picture decorated inside a frame.

>go to engine room
You can't go that way.

>go to hallway
You walk to the hallway.

hallway
You can see a steel door and a bunker door here.

>go to engine room
You walk to the Engine room.

Engine room
You can see a bunker door and a welding unit here.

>go to hallway
You can't go that way.

* * *

>go to hallway
You walk to the hallway.

hallway
You can see a steel door, a bunker door and a welding unit here.

>go to engine room
You can't go that way.

>open bunker door
You open the bunker door.

>go to engine room
You walk to the Engine room.

Engine room
You can see a bunker door here.

>go to hallway
You can't go that way.

* * *

>shoot padlock
Why do you want to shoot the padlock?

>open door
Congratulations! You've cleared the demo.

>go to hallway
(the northern hallway)
You walk to the northern hallway.

northern hallway
You can see a steel door here.

>go to chamber
You walk to the Captain's Chamber.

Captain's Chamber
You can see a wooden desk (on which is a Captain's Log) here.

>go to hallway
You walk to the hallway.

hallway
You can see a steel door, a bunker door and a welding unit here.

>open bunker door
You open the bunker door.

* * *

>go to hallway
(the northern hallway)
You walk to the northern hallway.

northern hallway
You can see a steel door here.

>open door
Congratulations! You've cleared the demo.

* * *

>go to hallway
(the northern hallway)
You walk to the northern hallway.

northern hallway
You can see a steel door here.

>go to hallway
(the northern hallway)
You can't go that way.

>go south
southern hallway
You can see a bunker door and a welding unit here.

>go north
northern hallway
You can see a steel door here.

>shoot myself
You press the trigger but nothing happens, apparently you're out of ammunition.

* * *

>shoot padlock
Why do you want to shoot the padlock?

>shoot door
(the steel door)
Why do you want to shoot the steel door?

>shoot the window
Why do you want to shoot the porthole window?

* * *

>shoot yourself
That noun did not make sense in this context.

>shoot myself
You shoot yourself.

    *** Several days later, a cargo ship found the MV Valiant adrifting with the gulf stream. After repeated hailing with no response, the crew decided to approach the ship and investigate. To the crew's horror, there's not a single soul on board the ship. There were no sign of violence and destruction, nor any blood splatter. In a panic, the crew evacuated the ship as fast as they could. That was the last time people ever lay their eye upon the MV Valiant, for every search and rescue operation ended in failure. ***

Would you like to RESTART, RESTORE a saved game, QUIT or UNDO the last command?

* * *

>shoot chamber
You can't shoot a room

* * *

>shoot log
You can't see such thing.

>shoot welding unit
You can't reach into the hallway.

* * *

>shoot log
You can't see such thing.

>take books
You're carrying too many things already.

>inventory
You are carrying:
  a revolver pistol
  a brass key

>put brass key into the drawer
You put brass key into the drawer.

>close the drawer
You close the drawer.

>lock the drawer
(with the revolver pistol)
That doesn't seem to fit the lock.

>shoot the key
The drawer isn't open.

* * *

>shoot log
You can't see such thing.

>look log
You can't see any such thing.

>shoot door
You shoot the steel door.
The bullet blasts forward at sonic speed, hitting the padlock right in the center. An ear-bleeding metallic impact sound ensues. You see that the padlock is now completely destroyed.

>dial padlock to 0040
The padlock is already dealt with.

>dial padlock to 040
The lock takes four digits.

>shoot
What do you want to shoot?

>shoot myself
You press the trigger but nothing happens, apparently you're out of ammunition.

* * *

>examine the picture
A wedding picture of a happy couple in a decorated wooden frame.
One particular book piques your interest. As you read through it, you seem to recall a certain passcode - 3846.

>examine papers
You can't see any such thing.

* * *

>examine paper
A few paper file concerning the course of the ship - MV Valiant and its crew member. You see your name under the title First Mate.
You seem to recall a certain passcode - 7042.

>dial padlock to 7042
You turn the dial, but nothing happens.

>examine picture
A wedding picture of a happy couple in a decorated wooden frame.
You seem to recall a certain passcode - 1015.

>dial padlock to 1015
You turn the dial, but nothing happens.

>dial the padlock to 9868
You turn the dial, but nothing happens.

>examine books
You quickly look through the book names, some of them sound quite familiar to you.

>examine books
You give these books a closer look, pick up a few and flick through them as you check if there's anything worth noting.

>examine books
One particular book piques your interest. As you read through it, you see your fragmented memories of yore flying by before your eyes. A four-digit code emerges from deep within - 5945

>dial the padlock to 5945
The padlock clicks unlocked.

* * *

>wear leather jacket
(first taking the leather jacket)
You're carrying too many things already.

>inventory
You are carrying:
  a revolver pistol
  a brass key

>put brass key on the desk
You put the brass key on the desk.

>wear leather jacket
(first taking the leather jacket)
You put on the leather jacket.

>take key
Taken.

>take pillow
You're carrying too many things already.

* * *

>put key on the table
You put the brass key on the table.

>wear jacket
(first taking the leather jacket)
You now have more pockets to store items.

>wear jacket
You're already wearing that!

>take off jacket
You feel safe and comfy in it, it is not much but it's thick enough to protect you against the cold.

>put jacket into the wardrobe
You feel safe and comfy in it, it is not much but it's thick enough to protect you against the cold.

>inventory
You are carrying:
  a leather jacket (being worn)
  a revolver pistol

>take pillow
Taken.

>take quilt
Taken.

>examine pillow
TODO - pillow

>shoot pillow
You shoot the pillow.

>examine pillow
TODO - pillow

* * *

>shoot jacket
You shoot the leather jacket.

>examine jacket
You see nothing special about the leather jacket.

* * *

>look
northern hallway
Typical narrow hallway seen on common naval vessels, the engine room is south of the hallway. North of the hallway is the stairs to the upper deck, but the hatch door is closed.

You can see a steel door here.

>shoot lock
That noun did not make sense in this context.

>shoot padlock
You shoot the padlock.
The bullet blasts forth at sonic speed, hitting the padlock right in the center of mass. An ear-bleeding metallic impact sound and blinding sparks ensue. You see that the padlock is now completely destroyed.

>look
Cabin
TODO - Player room intro

You can see a steel door, a table on which is a few paper, a bed, a bookshelf in which are some books, a wardrobe in which is a leather coat, a closet in which is a few cups, a desk with a drawer on which is a picture and a scratched window.

* * *

>look
northern hallway
Typical narrow hallway seen on common naval vessels, the engine room is south of the hallway. North of the hallway is the stairs to the upper deck, but the hatch door is closed.

You can see a steel door here.

>inspect bookshelf
A fairly large metallic bookshelf fixed to the wall and ceiling. It is filled with all kinds of books - "How to Avoid Huge Ships, Beyond Good & Evil, Strange Creatures at Sea etc.". 

In the bookshelf are some books.

* * *

>look
northern hallway
Typical narrow hallway seen on common naval vessels, the engine room is south of the hallway. North of the hallway is the stairs to the upper deck, but the hatch door is closed.

You can see a steel door here.

>look stairs
You can't see any such thing.

* * *

>look bed
A standard sized iron-framed bed that is soldered to the floor. 

On the bed are a pillow and a quilt.

* * *

>turn padlock to 4956
I only understood you as far as wanting to turn the padlock.

* * *

>turn padlock to 3413
To open the padlock, try DIAL PADLOCK TO 4 digit number.

>sleep
You aren't feeling especially drowsy.

>listen
You can hear faint hummings of electricity.

>smell
You can smell thin salt air, indicating sea nearby.

>look table
A simple wooden table fixed in place. 

On the table is a few paper.

>look around
Cabin
Spacious ship cabin for a single sailor. The only thing that deviates from the overall pragmatic design is the refined wooden plate floor. There's a single porthole window on the plain steel wall, its rim is a little bit rusty. Despite scattered scratches, bulges, wear and tear on the wall, the cabin withstood the vicissitudes of time.

You can see a steel door that is locked under a combination padlock, a table on which is a few paper, a bed, a bookshelf in which are some books, a wardrobe in which is a leather coat, a closet in which is a few cups, a desk with a built-in drawer. On the desk is a picture decorated inside a frame.

>look
Cabin
Spacious ship cabin for a single sailor. The only thing that deviates from the overall pragmatic design is the refined wooden plate floor. There's a single porthole window on the plain steel wall, its rim is a little bit rusty. Despite scattered scratches, bulges, wear and tear on the wall, the cabin withstood the vicissitudes of time.

You can see a steel door that is locked under a combination padlock, a table on which is a few paper, a bed, a bookshelf in which are some books, a wardrobe in which is a leather coat, a closet in which is a few cups, a desk with a built-in drawer. On the desk is a picture decorated inside a frame.

>look
Cabin
Spacious ship cabin for a single sailor. The only thing that deviates from the overall pragmatic design is the refined wooden plate floor. There's a single porthole window on the plain steel wall, its rim is a little bit rusty. Despite scattered scratches, bulges, wear and tear on the wall, the cabin withstood the vicissitudes of time.

You can see a steel door that is locked under a combination padlock, a table on which is a few paper, a bed, a bookshelf in which are some books, a wardrobe in which is a leather coat, a closet in which is a few cups, a desk with a built-in drawer. On the desk is a picture decorated inside a frame.

>look table
A simple wooden table fixed in place. 

On the table is a few paper.

>look
Cabin
Spacious ship cabin for a single sailor. The only thing that deviates from the overall pragmatic design is the refined wooden plate floor. There's a single porthole window on the plain steel wall, its rim is a little bit rusty. Despite scattered scratches, bulges, wear and tear on the wall, the cabin withstood the vicissitudes of time.

You can see a steel door that is locked under a combination padlock, a table on which is a few paper, a bed, a bookshelf in which are some books, a wardrobe in which is a leather coat, a closet in which is a few cups, a desk with a built-in drawer. On the desk is a picture decorated inside a frame.

* * *

>investigate books
You quickly skim through the book names, some of them sound quite familiar to you.

>read books
You don't seem to want to read right now. Better just investigate them.

* * *

>shoot padlock with pistol
I only understood you as far as wanting to shoot the padlock.

* * *

>shoot pistol with pistol
(ignoring the unnecessary words "with pistol")

Are you actually serious?

>open drawer with key
That's unlocked at the moment.

>lock drawer
What do you want to lock the drawer with?

>lock drawer with key
First you would have to close the drawer.

>close drawer
You close the drawer.

>lock drawer with key
You lock the drawer.

* * *

>find drawer
You feel nothing unexpected.

>look on
You can't see any such thing.

>look on table
You can't see any such thing.

>look table
A simple wooden table fixed in place. 

On the table is a few paper.

* * *

>look on table
A simple wooden table fixed in place. 

On the table is a few paper.

>look on desk
A nice sturdy wooden desk modified to be fixed in place to prevent it from moving during stormy weather. A built-in drawer with a keyhole is below its working surface. A fancy picture frame is on the table.

On the desk is a wedding picture.

>dial padlock
I didn't understand that sentence.

* * *

>dial padlock
You should specify what number you wish to dial to.

>dial padlock to
You should specify what number you wish to dial to.

>dial padlock to 2
The lock takes four digits.

>dial padlock to 2415
You turn the dial, but nothing happens.

>dial padlock to 1234
You turn the dial, but nothing happens.

>dial padlock to 1144
You turn the dial, but nothing happens.

>look books
You quickly skim through the book names, some of them sound quite familiar to you.

>look books
You pick up a few and flick through them as you check if there's anything worth noting, but you found nothing particualrly interesting to you. Maybe take another closer look?

>look books
One particular book piques your interest. As you read through it, you see your fragmented memories of yore flying by before your eyes. A four-digit code emerges from deep within - 4358

>dial padlock to 4358
The padlock clicks unlocked.

>open padlock
It isn't something you can open.

>open steel door
Congratulations!

>go to hallway
You walk to the hallway.

hallway
You can see a steel door and a welding unit here.

>feel the wall
Your hand touches the cold steel wall. you can feel the slight vibration repeating sporadically, some kind of giant machine is running somewhere near.

* * *

>look book
You quickly skim through the book names, some of them sound quite familiar to you.

>read book
You really don't want to waste time reading them right now. Better just investigate them.

>examine book
You pick up a few and flick through them as you check if there's anything worth noting, but you found nothing particualrly interesting to you. Maybe take another closer look?

>inspect book
One particular book piques your interest. As you read through it, you seem to recall a certain passcode - 5666.

>HELP
That's not a verb I recognise.

>help
That's not a verb I recognise.

* * *

>shoot window
You shoot the porthole window.
Even though designed to withstand the most violent storm, The window is no match for a bullet. It shatters into pieces behind the exiting bullet, and the bullet disappears into the perfect darkness outside. Cold wind pours in from the window, giving you a shivering chill. Suddenly, through the shatter window, you see the blackness jerks, as if it is alive. For a moment you're convinced that you're seeing things, but the blackness twirls faster and faster, then swarms into the cabin...

    *** Several days later, a cargo ship found the MV Valiant adrifting with the gulf stream. After repeated hailing with no response, the crew decided to approach the ship and investigate. To the crew's horror, there's not a single soul on board the ship. There was no sign of violence or ruination, nor any shattered window or scortch mark. In a panic, the crew fled the ship and drove away as fast as they can. That was the last time men have ever laid their eyes upon the MV Valiant, for every subsequent search and rescue attempts ended in utter failure. ***

Would you like to RESTART, RESTORE a saved game, QUIT or UNDO the last command?

* * *

>take ammo
You're carrying too many things already.

>wear coat
(first taking the leather coat)
You're carrying too many things already.

>put pistol on desk
You put the revolver pistol on the desk.

>wear coat
(first taking the leather coat)
You now have more pockets to store items.

>take pistol
Taken.

>inventory
You are carrying:
  a revolver pistol
  a leather coat (being worn)
  a brass key

>take ammo
Taken.

>inventory
You are carrying:
  an ammo
  a revolver pistol
  a leather coat (being worn)
  a brass key

>reload pistol with ammo
That's not a verb I recognise.

* * *

>put brass key on table
You put the brass key on the table.

>look table
A simple wooden table fixed in place. 

On the table are a brass key and a few paper.

>take ammo
Taken.

>reload pistol with ammo
You've successfully reloaded the revolver pistol, now it has 2 rounds.

>shoot padlock
You shoot the padlock.
You raise the pistol and aim your shot, your hand steady and stable. The bullet blasts forth at sonic speed, hitting the padlock right in the center of mass. An ear-bleeding metallic impact sound and blinding sparks ensue. You see that the padlock is now completely destroyed.

>shoot myself
You shoot yourself.

    *** Several days later, a cargo ship found the MV Valiant adrifting with the gulf stream. After repeated hailing with no response, the crew decided to approach the ship and investigate. To the crew's horror, there's not a single soul on board the ship. There was no sign of violence or ruination, nor any blood splatter or scortch mark. In a panic, the crew fled the ship and drove away as fast as they can. That was the last time men have ever laid their eyes upon the MV Valiant, for every subsequent search and rescue attempts ended in utter failure. ***

Would you like to RESTART, RESTORE a saved game, QUIT or UNDO the last command?

>undo
Cabin
[Previous turn undone.]

>undo
Cabin
[Previous turn undone.]

>reload pistol with ammo
You've successfully reloaded the revolver pistol, now it has 3 rounds.

>reload pistol with ammo
You've successfully reloaded the revolver pistol, now it has 4 rounds.

>reload pistol with ammo
You've successfully reloaded the revolver pistol, now it has 5 rounds.

>reload pistol with ammo
You've successfully reloaded the revolver pistol, now it has 6 rounds.

* * *

>throw key
Dropped.

>take ammo
Taken.

* * *

>reload pistol with ammo
You've successfully reloaded the revolver pistol, now it has 2 rounds.

>inventory
You are carrying:
  a revolver pistol

* * *

>look desk
A nice sturdy wooden desk modified to be fixed in place to prevent it from moving during stormy weather. A built-in drawer with a keyhole is below its working surface.

On the desk is a wedding picture.

>dial padlock to
You should specify what number you wish to dial to.

* * *

>shoot drawer
Why do you want to shoot the drawer?

>look closet
TODO - Closet 

In the closet is a few cups.

>look cups
You see nothing special about the few cups.

>take cups
The closet isn't open.

>open closet
It isn't something you can open.

* * *

>go south
southern hallway
This is the heart of the ship, you can see exposed wires zizaging from the floor to the roof, huge pipes coming down from the roof connecting to several big engines and big cylindrical containers. Juding by the sizes of these engines, the ship is definitely not some kind of huge war ship or giant cargo hauler. You can hear faint noises coming from the idle engines.

>go north
northern hallway
Typical narrow hallway seen on common naval vessels, the engine room is south of the hallway. North of the hallway is the stairs to the upper deck, but the hatch door is closed.

You can see a steel door here.

* * *

>go south
southern hallway
This is the heart of the ship, you can see exposed wires zizaging from the floor to the roof, huge pipes coming down from the roof connecting to several big engines and big cylindrical containers. Juding by the sizes of these engines, the ship is definitely not some kind of huge war ship or giant cargo hauler. You can hear faint noises coming from the idle engines.

>go south
(first opening the bunker door)

Engine room
This is the heart of the ship, you can see exposed wires zizaging from the floor to the roof, huge pipes coming down from the roof connecting to several big engines and big cylindrical containers. Juding by the sizes of these engines, the ship is definitely not some kind of huge war ship or giant cargo hauler. You can hear faint noises coming from the idle engines.

You can also see a welding unit, a workbench (on which are an old hammer and a broken screwdriver handle) and a control panel here.

>take handle
Taken.

>throw pistol
Dropped.

>take handle
Taken.

>look handle
A big screwdriver handle, the head is clearly snapped off, and nowhere to be found.

>search under workbench
You find the broken screwdriver head!

>look head
A screwdriver head, broken off from a handle. The tip was utterly destroyed by someone, you can only see that what is remaining resembles a torx tip.

>weld head with handle
You fire up the welding unit, flame bursts forward from the nuzzle. You try your best to weld the two pieces together, and somehow it works. Though not aligned perfectly, the screwdriver is reborn.

>inventory
You are carrying:
  a fixed screwdriver
  a brass key

>look
Engine room
You can see a revolver pistol, a bunker door, a welding unit and a workbench (on which is an old hammer) here.

* * *

>take handle
Taken.

>look handle
A big screwdriver handle, the head is clearly snapped off, and nowhere to be found. Where could it be?

>look under workbench
You find the broken screwdriver head!

>look handle
A big screwdriver handle, the head is clearly snapped off, and nowhere to be found.

>look welding unit
An oxyacetylene welding unit, judging by the pressure indicator, it is still usable.

>weld handle to head
You fire up the welding unit, flame bursts forward from the nuzzle. You try your best to weld the two pieces together, and somehow it works. Though not aligned perfectly, the screwdriver is reborn.

>inv
You are carrying:
  a fixed screwdriver
  a revolver pistol
  a brass key
  a leather coat (being worn)

* * *

>go south
(first opening the bunker door)

Engine room
This is the heart of the ship, you can see exposed wires zizaging from the floor to the roof, huge pipes coming down from the roof connecting to several big engines and big cylindrical containers. Juding by the sizes of these engines, the ship is definitely not some kind of huge war ship or giant cargo hauler. You can hear faint noises coming from the idle engines.

You can also see a welding unit, a workbench (on which are an old hammer and a broken screwdriver handle) and a control panel here.

>search under workbench
You find the broken screwdriver head!

>weld head to handle
You fire up the welding unit, flame bursts forward from the nuzzle. You try your best to weld the two pieces together, and somehow it works. Though not aligned perfectly, the screwdriver is reborn.

Taken.

>look
Engine room
This is the heart of the ship, you can see exposed wires zizaging from the floor to the roof, huge pipes coming down from the roof connecting to several big engines and big cylindrical containers. Juding by the sizes of these engines, the ship is definitely not some kind of huge war ship or giant cargo hauler. You can hear faint noises coming from the idle engines.

You can also see a welding unit, a workbench (on which is an old hammer) and a control panel here.

>look control panel
A electrical control panel with buttons and levers all over. The most important "Engine Start" button is covered by a steel protective shell with a big screw holding it in place.

* * *

>look stairs
Stairs to the upper deck, perhaps. But the hatch door is closed shut.

* * *

>go east
You can't go that way.

>go south
southern hallway
You can see a bunker door here.

>go south
(first opening the bunker door)

Engine room
You can see a bunker door, a welding unit and a workbench (on which are an old hammer and a broken screwdriver handle) here.

>take handle
You're carrying too many things already.

>throw gun
You can't see any such thing.

>throw pistol
Dropped.

>throw key
Dropped.

>take handle
Taken.

>search under workbench
You find the broken screwdriver head!

>weld handle to head
First.
Second.

>inventory
You are carrying:
  a fixed screwdriver

>weld screwdriver handle to screwdriver head
I didn't understand that sentence.

>weld screwdriver head to screwdriver handle
I didn't understand that sentence.

>weld
(the fixed screwdriver with the fixed screwdriver)
First.

* * *

>look screw
Six-lobed, star-patterned screw - a torx screw.

>look control panel
A electrical control panel with buttons and levers all over. The most important "Engine Start" button is covered by a steel protective shell with a big screw holding it in place.

>examine screw
Six-lobed, star-patterned screw - a torx screw.

* * *

>take screwdriver
Which do you mean, the flat screwdriver or the broken screwdriver handle?

* * *

>take handle
Taken.

>screw the screw with handle
You fire up the welding unit, flame bursts forward from the nuzzle. You try your best to weld the two pieces together, and somehow it works. Though not aligned perfectly, the screwdriver is reborn.

>screw the screw with screwdriver
You fire up the welding unit, flame bursts forward from the nuzzle. You try your best to weld the two pieces together, and somehow it works. Though not aligned perfectly, the screwdriver is reborn.

>screw the screw with screwdriver handle
You fire up the welding unit, flame bursts forward from the nuzzle. You try your best to weld the two pieces together, and somehow it works. Though not aligned perfectly, the screwdriver is reborn.

>screw the screw with broken screwdriver handle
You fire up the welding unit, flame bursts forward from the nuzzle. You try your best to weld the two pieces together, and somehow it works. Though not aligned perfectly, the screwdriver is reborn.

>weld workbench with handle
You don't possess any such thing.

>weld handle with workbench
You don't possess any such thing.

* * *

>wear jacket
(first taking the leather jacket)
You now have more pockets to store items.

Turn pass

>put jacket into the wardrobe
You feel safe and comfy in it, it is not much but it's thick enough to protect you against the cold.

You put leather jacket into the wardrobe.

Turn pass

>look wardrobe
Print the value of not broken 1 TODO - Wardrobe 

In the wardrobe is a leather jacket.

>wear jacket
(first taking the leather jacket)
You now have more pockets to store items.

>take off jacket
You take off the leather jacket.

>inventory
You are carrying:
  a leather jacket

* * *

>wear jacket
(first taking the leather jacket)
You now have more pockets to store items.

Turn pass

>place jacket into wardrobe
That's not a verb I recognise.

>put jacket into wardrobe
You feel safe and comfy in it, it is not much but it's thick enough to protect you against the cold.

Turn pass

>inventory
You are carrying:
  a leather jacket (being worn)

Turn pass

>take pistol
The drawer isn't open.

Turn pass

>put pistol into wardrobe
The drawer isn't open.

Turn pass

* * *

>put on jacket
(first taking the leather jacket)
You now have more pockets to store items.

>inventory
You are carrying nothing.

>take off jacket
You can't see any such thing.

* * *

>put on jacket
(first taking the leather jacket)
You now have more pockets to store items.

>take off jacket
You can't see any such thing.

* * *

>examine window
TODO - Window 

lol

* * *

>open drawer
It seems to be locked.

Turn pass

* * *

>put pistol into the wardrobe
The drawer isn't open.

Turn pass

* * *

>look the bed
TODO - BED 

Turn pass

>look under the bed
You find the brass key!

Turn pass

* * *

>look under bed
You find the brass key!

Turn pass

>open drawer
It seems to be locked.

Turn pass

>use brass key on drawer
That's not a verb I recognise.

>open drawer using brass key
I only understood you as far as wanting to open the drawer.

>brass key
That's not a verb I recognise.

>use brass key
That's not a verb I recognise.

* * *

>look under bed
You find the brass key!

Turn pass

>unlock drawer
(with the brass key)
You unlock the drawer.

Turn pass

>look inside drawer
In the drawer is a revolver pistol.

Turn pass

* * *

>look inside drawer
In the drawer is a revolver pistol.

Turn pass

* * *

>drawer
That's not a verb I recognise.

>look drawer
TODO - drawer 

Turn pass

>look inside drawer
You can't see inside, since the drawer is closed.

Turn pass

>look inside cabin
You can't see any such thing.

>look inside closet
In the closet is a few cups.

Turn pass

* * *

>open closet
It isn't something you can open.

Turn pass

* * *

>look ceiling light
You see nothing special about the ceiling light.

Turn pass

>toggle light switch
That's not a verb I recognise.

* * *

>grope for light switch
You switch the light switch on.

Cabin
TODO - Player room intro

You can see a steel door, a table (on which is a few paper), a bed (on which is a pillow), a bookshelf (in which are some books), a wardrobe (in which is a leather jacket), a closet (closed) (in which is a few cups), a scratched window and a desk here.

>examine light switch
The light switch is currently switched off.

Turn pass

* * *

>grope for light switch
You switch the light switch on.

Cabin
TODO - Player room intro

You can see a steel door, a table (on which is a few paper), a bed (on which is a pillow), a bookshelf (in which are some books), a wardrobe (in which is a leather jacket), a closet (closed) (in which is a few cups), a scratched window and a desk here.

>switch on the light switch
You can't see any such thing.

>switch on light switch
You can't see any such thing.

>look log
You can't see any such thing.

* * *

>grope for light switch
You switch the light switch on.

Cabin
TODO - Player room intro

You can see a steel door, a table (on which is a few paper), a bed (on which is a pillow), a bookshelf (in which are some books), a wardrobe (in which is a leather jacket), a closet (closed) (in which is a few cups), a scratched window and a desk here.

>examine steel door
You see nothing special about the steel door.

Turn pass

>look at steel door
You see nothing special about the steel door.

Turn pass

>examine padlock
You see nothing special about the padlock.

Turn pass

* * *

>grope for light switch
You switch the light switch on.

Cabin
TODO - Player room intro

You can see a steel door, a table (on which is a few paper), a bed (on which is a pillow), a bookshelf (in which are some books), a wardrobe (in which is a leather jacket), a closet (closed) (in which is a few cups), a scratched window and a desk here.

>take leather jacket
Taken.

>wear jacket
You now have more pockets to store items.

>look under bed
You find the brass key!

>unlock drawer
What do you want to unlock the drawer with?

>unlock drawer with brass key
You unlock the drawer.

>look into the drawer
You can't see inside, since the drawer is closed.

>open the drawer
You open the drawer, revealing a revolver pistol.

>take pistol
An antique revolver pistol lies silently in the drawer. The moment you see it, you feel something is awakening deep inside your memory. It is an Webley Mk. IV revolver, a memorial medal for a war veteran of a not so distant war.
You take the pistol and instinctly hit the break lever, flip the fore-piece forward and look into the cylinder to check how many bullets are left. To your disappointment, it seems there is only one .455 bullet left in the cylinder.

>open steel door
You cannot force open the door while there's a sturdy padlock holding it in place.

>look padlock
Bulky combination padlock with 4 digits, apparently someone put it on there, but who?

>cheat
Number: 1, passcode 40

>dial padlock to 0040
The padlock clicks unlocked.

>open steel door
TODO - Before Hallway Intro.

>go to hallway
You walk to the hallway.

hallway
You can see a steel door and a welding unit here.

* * *

>grope for light switch
You switch the light switch on.

Cabin
TODO - Player room intro

You can see a steel door, a table (on which is a few paper), a bed (on which is a pillow), a bookshelf (in which are some books), a wardrobe (in which is a leather jacket), a closet (closed) (in which is a few cups), a scratched window and a desk here.

>look under bed
You find the brass key!

>look desk
You see nothing special about the desk.

>examine desk
You see nothing special about the desk.

>open drawer
It seems to be locked.

>unlock drawer
(with the brass key)
You unlock the drawer.

>open drawer
You open the drawer, revealing a revolver pistol.

>take pistol
An antique revolver pistol lies silently in the drawer. The moment you see it, you feel something is awakening deep inside your memory. It is a Webley Mk. IV revolver, a memorial medal for a war veteran of a not so distant war.

You take the pistol and instinctly hit the break lever, flip the fore-piece forward and look into the cylinder to check how many bullets are left. To your disappointment, it seems there is only one .455 bullet left in the cylinder.

>close drawer
You close the drawer.

>lock drawer
What do you want to lock the drawer with?

>lock drawer with brass key
You lock the drawer.

>put key into drawer
The drawer is closed.

I beg your pardon?

>shoot door
You shoot the steel door.
The bullet blasts forth at sonic speed, hitting the padlock right in the center of mass. An ear-bleeding metallic impact sound and blinding sparks ensue. You see that the padlock is now completely destroyed.

>open door
TODO - Before Hallway Intro.

>switch off light switch
You switch the light switch off.

>wear jacket
(first taking the leather jacket)
You're carrying too many things already.

>go to hallway
You walk to the hallway.

hallway
You can see a steel door and a welding unit here.

>go to cabin
You walk to the Cabin.

Cabin
TODO - Player room intro

You can see a steel door, a table (on which is a few paper), a bed (on which is a pillow), a bookshelf (in which are some books), a wardrobe (in which is a leather jacket), a closet (closed) (in which is a few cups), a scratched window and a desk here.

>close the door
You close the steel door.

It is now pitch dark in here!

>open the door
TODO - Before Hallway Intro.

* * *

>look light switch
It is pitch dark, and you can't see a thing.

Turn pass

>grope for light switch
It is pitch dark, and you can't see a thing.

Turn pass

* * *

>look light switch
It is pitch dark, and you can't see a thing.

Turn pass

>examine light switch
It is pitch dark, and you can't see a thing.

Turn pass

>grope for light switch
You switch the light switch on.

Turn pass
Cabin
TODO - Player room intro

You can see a steel door, a table (on which is a Captain's Log), a bed, a bookshelf (in which are some books), a wardrobe (in which is a leather jacket), a closet (closed) (in which is a few cups), a scratched window and a drawer (closed) here.

>try to open the door
That's not a verb I recognise.

>open the door
TODO - Before Hallway Intro.

Turn pass

* * *

>open the steel door
You can't see any such thing.

>open steel door
You can't see any such thing.

>test a
(Testing.)

>[1] grope for light switch
You switch the light switch on.

Turn pass
Cabin
TODO - Player room intro

You can see a steel door, a table (on which is a Captain's Log), a bed, a bookshelf (in which are some books), a wardrobe (in which is a leather jacket), a closet (closed) (in which is a few cups), a scratched window and a drawer (closed) here.

>[2] examine steel door
This is just a typical steel door on a military vessel - heavy and sturdy. You notice there is an old padlock on the hasp. If you want to go out, you'll definitely need to get rid of this padlock.

Turn pass

>open steel door
sb.

Turn pass

* * *

>turn on light
You switch the light switch on.

Turn pass
Cabin
TODO - Player room intro

You can see a steel door, a table (on which is a Captain's Log), a bed, a bookshelf (in which are some books), a wardrobe (in which is a leather jacket), a closet (closed) (in which is a few cups), a scratched window and a drawer (closed) here.

>examine padlock
Bulky combination padlock with 4 digits, apparently someone put it on there, but who?

Turn pass

* * *

>look bed
It is pitch dark, and you can't see a thing.

>feel bed
You feel nothing unexpected.

>feel cabin
You can't see any such thing.

* * *

>feel the bed
You can feel the soft linen bedsheet.

>lie in the bed
That's not a verb I recognise.

* * *

>listen
All you can hear is the sound of silence.

You hear nothing unexpected.

>feel the pillow
You feel nothing unexpected.

* * *

>listen
All you can hear is the sound of silence.

You hear nothing unexpected.

I beg your pardon?

I beg your pardon?

>feel the bed
You can feel the smooth linen bedsheet, a soft pillow. Nothing special about it, but lying in the bed makes you feel at ease.

>feel the pillow
Bouncy feather pillow, soft and warm to the touch.

wow!

>smell
You can smell thin salt air, indicating sea nearby.

* * *

>listen
All you can hear is the sound of silence.

You hear nothing unexpected.

>hear
What do you want to hear?

>think about the bed
I only understood you as far as wanting to think.

>think bed
I only understood you as far as wanting to think.

>grope for light switch
You switch the light switch on.

Cabin
TODO - Player room intro

You can see a steel door, a table (on which is a few paper), a bed (on which is a pillow), a bookshelf (in which are some books), a wardrobe (in which is a leather jacket), a closet (closed) (in which is a few cups), a scratched window and a desk here.

>search under bed
You can't see any such thing.

>look under bed
You find the brass key!

>open drawer
It seems to be locked.

* * *

>open drawer
You open the drawer, revealing a revolver pistol.

>take pistol
An antique revolver pistol lies silently in the drawer. The moment you see it, you feel something is awakening deep inside your memory. It is an Webley Mk. IV revolver, a memorial medal for a war veteran of a not so distant war.

You take the pistol and instinctly hit the break lever, flip the fore-piece forward and look into the cylinder to check how many bullets are left. To your disappointment, it seems there is only one .455 bullet left in the cylinder.

>close drawer
You close the drawer.

>put pistol into drawer
You put revolver pistol into the drawer.

>take pistol
You can't see any such thing.

* * *

>listen
All you can hear is the sound of silence.

You hear nothing unexpected.

>flip switch
It's pitch black, and you can't see a thing.

As soon as you hit the switch, glorious radiance pours down from the ceiling light, filling the room and forcing the darkness to recede. For a moment you are almost blinded by it.

Cabin
Spacious ship cabin for a single sailor. The only thing that deviates from the overall pragmatic design is the refined wooden plate floor. There's a single porthole window on the plain steel wall, its rim is a little bit rusty. Despite scattered scratches, bulges, wear and tear on the wall, the cabin withstood the vicissitudes of time.

You can see a steel door that is locked under a combination padlock, a table on which is a few paper, a bed, a bookshelf in which are some books, a wardrobe in which is a leather coat, a closet in which is a few cups, a desk with a built-in drawer. On the desk is a picture decorated inside a frame.

You are still quite confused about the situation, but you somehow feel a sense of urgency, as if something bad is about to happen. Anyway, you need to get out of the room and find out what this is all about.

>listen
You can hear faint hummings of electricity.

* * *

>listen
All you can hear is the sound of silence.

You hear nothing unexpected.

>smell
You smell nothing unexpected.

>taste
What do you want to taste?

>taste pillow
You taste nothing unexpected.

>try to feel
That's not a verb I recognise.

>try to feel the pillow
That's not a verb I recognise.

* * *

>feel
What do you want to feel?

>fell
You can't see any such thing.

>feel
What do you want to feel?

>wow
You can't see any such thing.

>listen
All you can hear is the sound of silence.

>hear
What do you want to hear?

>listen
All you can hear is the sound of silence.

>listen
All you can hear is the sound of silence.

>listen
All you can hear is the sound of silence.

wow!

>listen
All you can hear is the sound of silence.

wow!

>feel light switch
You feel nothing unexpected.

wow!

* * *

>feel light switch
You get off the bed, grope for a light switch along the wall. Your finger touches a metal switch, this must be it.

It is pitch dark, and you can't see a thing.

>open light switch
It isn't something you can open.

>switch light switch
You switch the light switch on.

Cabin
TODO - Player room intro

You can see a steel door, a table (on which is a few paper), a bed (on which is a pillow), a bookshelf (in which are some books), a wardrobe (in which is a leather jacket), a closet (closed) (in which is a few cups), a scratched window and a desk here.

>switch light switch
You switch the light switch off.

If this is a room, surely there must be a light switch somewhere.

It is now pitch dark in here!

>open steel door
You cannot force open the door while there's a sturdy padlock holding it in place.

>switch light switch
You switch the light switch on.

Cabin
TODO - Player room intro

You can see a steel door, a table (on which is a few paper), a bed (on which is a pillow), a bookshelf (in which are some books), a wardrobe (in which is a leather jacket), a closet (closed) (in which is a few cups), a scratched window and a desk here.

>examine passcode of padlock
You can't see any such thing.

* * *

>feel light switch
You get off the bed, grope for a light switch along the wall. Your finger touches a metal switch, this must be it.

It is pitch dark, and you can't see a thing.

>flip light switch
As soon as you hit the switch, glorious radiance pours down from the ceiling light, filling the room and forcing the darkness to recede. For a moment you are almost blinded by it.

Cabin
Spacious ship cabin for a single sailor. The only thing that deviates from the overall pragmatic design is the refined wooden plate floor. There's a single porthole window on the plain steel wall, its rim is a little bit rusty. Despite scattered scratches, bulges, wear and tear on the wall, the cabin withstood the vicissitudes of time.

You can see a steel door that is locked under a combination padlock, a table on which is a few paper, a bed, a bookshelf in which are some books, a wardrobe in which is a leather coat, a closet in which is a few cups, a desk with a drawer on which is a picture and a porthole window.

You are still quite confused about the situation, but you somehow feel a sense of urgency. Anyway, you need to get out of the room and find out what is this all about.

* * *

>examine books
You can't see any such thing.

>switch light
You switch the light switch on.

Cabin
TODO - Player room intro

You can see a steel door, a table (on which is a few paper), a bed (on which is a pillow), a bookshelf (in which are some books), a wardrobe (in which is a leather jacket), a closet (closed) (in which is a few cups), a scratched window and a desk (on which is a wedding picture) here.

>examine books
You see nothing special about the books.

>examine books
You see nothing special about the books.

>examine books
You seem to recall a certain passcode - 3429

>examine books
You see nothing special about the books.

* * *

>switch light
You switch the light switch on.

Cabin
TODO - Player room intro

You can see a steel door that is locked under a combination padlock, a table on which is a few paper, a bed, a bookshelf in which are some books, a wardrobe in which is a leather coat, a closet in which is a few cups, a desk with a drawer on which is a picture and a scratched window.

>take books
Why would you take these books with you?

>inventory
You are carrying nothing.

* * *

>switch light
You switch the light switch on.

Cabin
TODO - Player room intro

You can see a steel door that is locked under a combination padlock, a table on which is a few paper, a bed, a bookshelf in which are some books, a wardrobe in which is a leather coat, a closet in which is a few cups, a desk with a drawer on which is a picture and a scratched window.

>put books on desk
(first taking the books)
Why would you take these books with you?

* * *

>switch light
You switch the light switch on.

Cabin
TODO - Player room intro

You can see a steel door that is locked under a combination padlock, a table on which is a few paper, a bed, a bookshelf in which are some books, a wardrobe in which is a leather coat, a closet in which is a few cups, a desk with a drawer on which is a picture and a scratched window.

>open drawer
It seems to be locked.

>look under wardrobe
You find nothing of interest.

>look under desk
You find nothing of interest.

>look under bed
You find the brass key!

>unlock drawer
(with the brass key)
You unlock the drawer.

* * *

>open drawer
You open the drawer, revealing a revolver pistol.

>take pistol
An antique revolver pistol lies silently in the drawer. The revolver is a Webley Mk. IV revolver, a memorial medal for a war veteran of a not so distant war.
The moment you see it, you feel something is awakening deep inside your memory, you seem to recall a certain passcode - 5352.

You take the pistol and instinctly hit the break lever, flip the fore-piece forward and look into the cylinder to check how many bullets are left. To your disappointment, it seems there is only one .455 bullet left in the cylinder.

>look bed
TODO - BED 

On the bed are a pillow and a quilt.

>look desk
On the desk is a wedding picture.

* * *

>feel the quilt
Soft, handcrafted cotton quilt.

>feel the pillow
Bouncy feather pillow, soft and warm to the touch.

>feel myself
You achieve nothing by this.

If this is a room, surely there must be a light switch somewhere.

* * *

>feel myself
Limbs? Check. Legs? Check. Head? Check. Eyes? Check. Apparently your eyes are fine, it's just that the room is too dark.

what happened?

>switch light
You switch the light switch on.

Cabin
TODO - Player room intro

You can see a steel door, a table (on which is a few paper), a bed (on which are a pillow and a quilt), a bookshelf (in which are some books), a wardrobe (in which is a leather jacket), a closet (closed) (in which is a few cups), a scratched window and a desk (on which is a wedding picture) here.

>examine books
You quickly look through the book names, some of them sound quite familiar to you.

* * *

>examine books
You give these books a closer look, pick up a few and flick through them as you check if there's anything worth noting.

>examine books
One particular book piques your interest. As you read through it, you seem to recall a certain passcode - 7733.

>dial padlock to 7733
You turn the dial, but nothing happens.

>examine the wedding picture
You see nothing special about the wedding picture.

>examine picture
You see nothing special about the wedding picture.

* * *

>feel myself
Limbs? Check. Legs? Check. Head? Check. Eyes? Check. Apparently your eyes are fine, it's just that the room is too dark.

what happened?

>cheat
Number: 1, passcode 7350   6738 9002 4542 4876 Game_Clue 2

* * *

>examine coat
You can't see any such thing.

>test a
(Testing.)

>[1] switch on light switch
You switch the light switch on.

Cabin
TODO - Player room intro

You can see a steel door that is locked under a combination padlock, a table on which is a few paper, a bed, a bookshelf in which are some books, a wardrobe in which is a leather coat, a closet in which is a few cups, a desk with a drawer on which is a picture and a scratched window.

>[2] examine steel door
This is just a typical steel door on a military vessel - heavy and sturdy. You notice there is an old padlock on the hasp. If you want to go out, you'll definitely need to get rid of this padlock.

>[3] open steel door
You cannot force open the door while there's a sturdy padlock holding it in place.

>[4] look under bed
You find the brass key!

>[5] unlock drawer
(with the brass key)
You unlock the drawer.

>[6] open drawer
You open the drawer, revealing a revolver pistol.

>[7] take pistol
An antique revolver pistol lies silently in the drawer. The revolver is a Webley Mk. IV revolver, a memorial medal for a war veteran of a not so distant war.
The moment you see it, you feel something is awakening deep inside your memory, you seem to recall a certain passcode - 6488.

You take the pistol and instinctly hit the break lever, flip the fore-piece forward and look into the cylinder to check how many bullets are left. To your disappointment, it seems there is only one .455 bullet left in the cylinder.

* * *

>examine bed
It is pitch dark, and you can't see a thing.

>feel bed
You can feel the smooth linen bedsheet, a soft pillow. Nothing special about it, but lying in the bed makes you feel at ease.

>feel quilt
Soft, handcrafted cotton quilt.

If this is a room, surely there must be a light switch somewhere.

* * *

>feel bed
You can feel the smooth linen bedsheet, a soft pillow. Nothing special about it, but lying in the bed makes you feel at ease.

>touch myself
Limbs? Check. Legs? Check. Head? Check. Eyes? Check. Apparently your eyes are fine, it's just that the room is too dark.

>feel pillow
Bouncy feather pillow, soft and warm to the touch.

If this is a room, surely there must be a light switch somewhere.

>feel light switch
Your finger touches a switch, this must be it.

>open light
It isn't something you can open.

>switch on light
You switch the light switch on.

Cabin
TODO - Player room intro

You can see a steel door that is locked under a combination padlock, a table on which is a few paper, a bed, a bookshelf in which are some books, a wardrobe in which is a leather coat, a closet in which is a few cups, a desk with a drawer on which is a picture and a scratched window.

>search under bed
You can't see any such thing.

* * *

>feel bed
You can feel the smooth linen bedsheet, a soft pillow. Nothing special about it, but lying in the bed makes you feel at ease.

what happened?

>cheat
Number: 0, passcode 3016   6208 8104 9086 4937 Game_Clue 0

* * *

>look
Total Darkness
You can't even see your hands!

>look
Total Darkness
You can't even see your hands!

I beg your pardon?

>look
Total Darkness
You can't even see your hands!

If this is a room, surely there must be a light switch somewhere.

>look
Total Darkness
You can't even see your hands!

* * *

I beg your pardon?

>look
Total Darkness
You can't even see your hands!

>flip switch
It's pitch black, and you can't see a thing.

As soon as you hit the switch, glorious radiance pours down from the ceiling light, filling the room and forcing the darkness to recede. For a moment you are almost blinded by it.

lol
Cabin
Spacious ship cabin for a single sailor. The only thing that deviates from the overall pragmatic design is the refined wooden plate floor. There's a single porthole window on the plain steel wall, its rim is a little bit rusty. Despite scattered scratches, bulges, wear and tear on the wall, the cabin withstood the vicissitudes of time.

You can see a steel door that is locked under a combination padlock, a table on which is a few paper, a bed, a bookshelf in which are some books, a wardrobe in which is a leather coat, a closet in which is a few cups, a desk with a built-in drawer. On the desk is a picture decorated inside a frame.

You are still quite confused about the situation, but you somehow feel a sense of urgency, as if something bad is about to happen. Anyway, you need to get out of the room and find out what this is all about.

>look
Cabin
Spacious ship cabin for a single sailor. The only thing that deviates from the overall pragmatic design is the refined wooden plate floor. There's a single porthole window on the plain steel wall, its rim is a little bit rusty. Despite scattered scratches, bulges, wear and tear on the wall, the cabin withstood the vicissitudes of time.

You can see a steel door that is locked under a combination padlock, a table on which is a few paper, a bed, a bookshelf in which are some books, a wardrobe in which is a leather coat, a closet in which is a few cups, a desk with a built-in drawer. On the desk is a picture decorated inside a frame.

lol

>look shelf
You can't see any such thing.

>look bookshelf
TODO - Bookshelf 

In the bookshelf are some books.

lol

>read book
You can't see any such thing.

>look book
You can't see any such thing.

>read books
lol

>look books
You quickly skim through the book names, some of them sound quite familiar to you.

lol

>inspect books
That's not a verb I recognise.

>investigae books
That's not a verb I recognise.

>investigate books
That's not a verb I recognise.

>check books
You feel nothing unexpected.

lol

* * *

>look
Total Darkness
You can't even see your hands!

>stand up
You get off the bed.

Total Darkness
You wake up, from an unbearable headache, it is as if you've been through a terrible nightmare. But what is worse is that you seem to have lost a large portion of your memory. It is a strange feeling - names, languages and general knowledge, of these you know still, but you can't remember the most important things at this moment - where the hell are you. 

You open your eyes as the acute headache subsides but you can't see anything. It is the most overwhelming darkness ever - it was not merely the darkness that came out of absence of light, it was much more sinister, almost as if something behind the darkness is watching your every move. You stretch your eyes as wide as possible trying to capture the even dimmest glimmer of light but still nothing but blackness.

You are certain that you're in some kind of a room, the quiet and stale air gives away. Even though you cannot see anything, your other four senses are alright - you feel the pillow beneath your head and the soft, warm quilt over your body.

* * *

>filp light
That's not a verb I recognise.

>flip light
You switch the light switch on.

Cabin
TODO - Player room intro

You can see a steel door that is locked under a combination padlock, a table on which is a few paper, a bed, a bookshelf in which are some books, a wardrobe in which is a leather coat, a closet in which is a few cups, a desk with a drawer on which is a picture and a scratched window.

>search under bed
You find the brass key!

>search
(the brass key)
You find nothing of interest.

>look bed
TODO - BED 

On the bed are a pillow and a quilt.

* * *

>flip light
It's pitch black, and you can't see a thing.

As soon as you hit the switch, glorious radiance pours down from the ceiling light, filling the room and forcing the darkness to recede. For a moment you are almost blinded by it.

Cabin
Spacious ship cabin for a single sailor. The only thing that deviates from the overall pragmatic design is the refined wooden plate floor. There's a single porthole window on the plain steel wall, its rim is a little bit rusty. Despite scattered scratches, bulges, wear and tear on the wall, the cabin withstood the vicissitudes of time.

You can see a steel door that is locked under a combination padlock, a table on which is a few paper, a bed, a bookshelf in which are some books, a wardrobe in which is a leather coat, a closet in which is a few cups, a desk with a built-in drawer. On the desk is a picture decorated inside a frame.

You are still quite confused about the situation, but you somehow feel a sense of urgency, as if something bad is about to happen. Anyway, you need to get out of the room and find out what this is all about.

>look bed
A large sized iron-framed crew bed that is soldered to the floor, apparently too luxurious for average crew member. As you exmaine the bed, your eye caught a glimpse of an object. It seems that something is under the bed.

On the bed are a pillow and a quilt.

>take brass key
You can't see any such thing.

>search under bed
You find the brass key!

>look bed
A standard sized iron-framed bed that is soldered to the floor. 

On the bed are a pillow and a quilt.

* * *

>look bed
A large sized iron-framed crew bed that is soldered to the floor, apparently too luxurious for average crew member. As you exmaine the bed, your eye caught a glimpse of an object. It seems that something is under the bed.

On the bed are a pillow and a quilt.

>search under bed
You find the brass key!

* * *

>flip light
You switch the light switch off.

It is now pitch dark in here!

>flip light
You switch the light switch on.

Cabin
Spacious ship cabin for a single sailor. The only thing that deviates from the overall pragmatic design is the refined wooden plate floor. There's a single porthole window on the plain steel wall, its rim is a little bit rusty. You can see there are scattered scratches, bulges, wear and tear on the wall silently telling the vicissitudes of time.

You can see a steel door that is locked under a combination padlock, a table on which is a few paper, a bed, a bookshelf in which are some books, a wardrobe in which is a leather coat, a closet in which is a few cups, a desk with a drawer on which is a picture and a porthole window.

>search under bed
You find the brass key!

>inspect
That's not a verb I recognise.

>look brass key
You see nothing special about the brass key.

>look picture
A wedding picture of a happy couple in a decorated wooden frame.
You seem to recall a certain passcode - 4185.

* * *

>look on table
You can't see any such thing.

* * *

>look window
A single porthole window full of small scratches, the rim is a bit rusty. You cannot see anything through it, it's pitch black outside. Even though the diameter could fit a person, it is not designed to be opened.

>look desk
On the desk is a wedding picture.

* * *

>look ammo
You see nothing special about the ammo.

>take ammo
Taken.

>test a
(Testing.)

>[1] switch on light switch
That's already on.

>[2] examine steel door
This is just a typical steel door on a military vessel - heavy and sturdy. You notice there is an old padlock on the hasp. If you want to go out, you'll definitely need to get rid of this padlock.

>[3] open steel door
You cannot force open the door while there's a sturdy padlock holding it in place.

>[4] look under bed
You find the brass key!

>[5] unlock drawer
What do you want to unlock the drawer with?

>[6] open drawer
It seems to be locked.

>[7] take pistol
You can't see any such thing.

>reload pistol with ammo
That's not a verb I recognise.

* * *

>weld
What do you want to weld?

>test a
(Testing.)

>[1] switch on light switch
That's already on.

>[2] examine steel door
This is just a typical steel door on a military vessel - heavy and sturdy. You notice there is an old padlock on the hasp. If you want to go out, you'll definitely need to get rid of this padlock.

>[3] open steel door
You cannot force open the door while there's a sturdy padlock holding it in place.

>[4] look under bed
You find the brass key!

>[5] unlock drawer
(with the brass key)
You unlock the drawer.

>[6] open drawer
You open the drawer, revealing a revolver pistol.

>[7] take pistol
An antique revolver pistol lies silently in the drawer. The revolver is a Webley Mk. IV revolver, a memorial medal for a war veteran of a not so distant war.
The moment you see it, you feel something is awakening deep inside your memory, you see the bloody battles unfolding before your eyes. For a moment you're lost in the reminiscence, all things seem so surreal. When you finally find your way back to the reality, you seem to recall something - Lieutenant Commander in navy before leaving, and that shiny Meritorious Service Medal. The next thing comes to your mind is a certain passcode of some importance - 9843.

You hold the pistol and instinctly hit the break lever, flip the fore-piece forward and look into the cylinder to check how many bullets are left. To your disappointment, it seems there is only one .455 bullet left in the cylinder.

* * *

>dial padlock to
I didn't understand that sentence.

* * *

>open door
You cannot force open the door while there's a sturdy padlock holding it in place.

If this is a room, surely there must be a light switch somewhere.

>open drawer
It seems to be locked.

>look under bed
You find the brass key!

* * *

>look drawer
A sturdy drawer with a built-in keyhole in the front.

>open drawer with key
That's unlocked at the moment.

>open drawer with key
That's unlocked at the moment.

* * *

>open drawer
It seems to be locked.

>search under bed
You find the brass key!

* * *

>cheat
Number: 4, passcode 2107   4983 8373 7449 5298 Game_Clue 0

>unlock drawer with key
That's unlocked at the moment.

* * *

>test a
(Testing.)

>[1] switch on light switch
That's already on.

>[2] examine steel door
This is just a typical steel door on a military vessel - heavy and sturdy. You notice there is an old padlock on the hasp. If you want to go out, you'll definitely need to get rid of this padlock.

>[3] open steel door
You cannot force open the door while there's a sturdy padlock holding it in place.

>[4] look under bed
You find the brass key!

>[5] unlock drawer
(with the brass key)
You unlock the drawer.

>[6] open drawer
You open the drawer, revealing a revolver pistol.

>[7] take pistol
An antique revolver pistol lies silently in the drawer. The model is Webley Mk. IV, a memorial medal for a war veteran of a not so distant war.

The moment you see it, you feel something is awakening deep inside your memory, you see the bloody battles unfolding before your eyes. For a moment you're lost in the reminiscence, all things seem so surreal. When you finally find your way back to the reality, you seem to recall something - Lieutenant Commander in navy before leaving, and that shiny Meritorious Service Medal. The next thing comes to your mind is a certain passcode of some importance - 8203.

You hold the pistol and instinctly hit the break lever, flip the fore-piece forward and look into the cylinder to check how many bullets are left. To your disappointment, it seems there is only one .455 bullet left in the cylinder.

>shoot padlock
You shoot the padlock.
You raise the pistol and aim your shot, your hand steady and stable. The bullet blasts forth at sonic speed, hitting the padlock right in the center of mass. An ear-bleeding metallic impact sound and blinding sparks ensue. You see that the padlock is now completely destroyed.

>go to hallway
(the northern hallway)
You can't go that way.

>open door
Congratulations! You've cleared the demo.

* * *

>go to hallway
(the northern hallway)
You walk to the northern hallway.

northern hallway
You can see a steel door here.

>go south
southern hallway
You can see a bunker door and a welding unit here.

>look welding unit
An old oxyacetylene welding unit, judging by the pressure indicator, it is still usable. This unit is equipped with wheels, so you can push it to other rooms.

>open bunker door
You open the bunker door.

>push welding unit to bunker door
You can't see any such thing.

>push welding unit to engine room
You can't see any such thing.

>push welding unit south
Engine room
You can see a bunker door here.

>push welding unit north
southern hallway
You can see a bunker door here.

>go north
northern hallway
You can see a steel door here.

>go cabin
You can't see any such thing.

>go to cabin
You walk to the Cabin.

Cabin
Spacious ship cabin for a single sailor. The only thing that deviates from the overall pragmatic design is the refined wooden plate floor. There's a single porthole window on the plain steel wall, its rim is a little bit rusty. Despite scattered scratches, bulges, wear and tear on the wall, the cabin withstood the vicissitudes of time.

You can see a steel door, a table on which is a few paper, a bed, a bookshelf in which are some books, a wardrobe in which is a leather coat, a closet in which is a few cups, a desk with a built-in drawer. On the desk is a picture decorated inside a frame.

>look door
This is just a typical steel door on a military vessel - heavy and sturdy. You notice there is an old padlock on the hasp. If you want to go out, you'll definitely need to get rid of this padlock.

* * *

>look padlock
Bulky combination padlock with 4 digits, you can dial it to any 4 digit number. Apparently someone put it on there, but who?

>test a
(Testing.)

>[1] switch on light switch
That's already on.

>[2] examine steel door
This is just a typical steel door on a military vessel - heavy and sturdy. You notice there is an old padlock on the hasp. If you want to go out, you'll definitely need to get rid of this padlock.

>[3] open steel door
You cannot force open the door while there's a sturdy padlock holding it in place.

>[4] look under bed
You find the brass key!

>[5] unlock drawer
(with the brass key)
You unlock the drawer.

>[6] open drawer
You open the drawer, revealing a revolver pistol.

>[7] take pistol
An antique revolver pistol lies silently in the drawer. The model is Webley Mk. IV, a memorial medal for a war veteran of a not so distant war.

The moment you see it, you feel something is awakening deep inside your memory, you see the bloody battles unfolding before your eyes. For a moment you're lost in the reminiscence, all things seem so surreal. When you finally find your way back to the reality, you seem to recall something - Lieutenant Commander in navy before leaving, and that shiny Meritorious Service Medal. The next thing comes to your mind is a certain passcode of some importance - 7016.

You hold the pistol and instinctly hit the break lever, flip the fore-piece forward and look into the cylinder to check how many bullets are left. To your disappointment, it seems there is only one .455 bullet left in the cylinder.

>shoot padlock
You shoot the padlock.
You raise the pistol and aim your shot, your hand steady and stable. The bullet blasts forth at sonic speed, hitting the padlock right in the center of mass. An ear-bleeding metallic impact sound and blinding sparks ensue. You see that the padlock is now completely destroyed.

>open door
Congratulations! You've cleared the demo.

* * *

>go south
southern hallway
You can see a bunker door and a welding unit here.

>look welding unit
An old oxyacetylene welding unit, although it's been sitting there for years, judging by the pressure indicator, it is still usable.

>open bunker door
You open the bunker door.

>push unit south
Engine room
You can see a bunker door here.

>look
Engine room
You can see a welding unit and a bunker door here.

* * *

>wear jacket
You can't see any such thing.

* * *

>flip switch
Total Darkness
It is pitch dark, and you can't see a thing.

As soon as you hit the switch, glorious radiance pours down from the ceiling light, filling the room and forcing the darkness to recede. For a moment you have to squeeze your eyes to adapt the sudden change.

Cabin
Spacious ship cabin for a single sailor. The only thing that deviates from the overall pragmatic design is the refined wooden plate floor. There's a single porthole window on the plain steel wall, its rim is a little bit rusty. Despite scattered scratches, bulges, wear and tear on the wall, the cabin withstood the vicissitudes of time.

You can see a steel door that is locked under a combination padlock, a table on which is a few paper, a bed, a bookshelf in which are some books, a wardrobe in which is a leather coat, a closet in which is a few cups, a desk with a drawer on which is a picture and a porthole window.

You are still quite confused about the situation, but you somehow feel a sense of urgency. Anyway, you need to get out of the room and find out what is this all about.

* * *

>stand up
You get off the bed.

It is pitch dark, and you can't see a thing.

>feel myself
Limbs? Check. Legs? Check. Head? Check. Eyes? Check. Apparently your eyes are fine, it's just that the room is too dark.

>check myself
It is pitch dark, and you can't see a thing.

* * *

>feel myself
Limbs? Check. Legs? Check. Head? Check. Eyes? Check. Apparently your eyes are fine, it's just that the room is too dark.

>feel pillow
Bouncy feather pillow, soft and warm to the touch.

>feel quilt
Soft, handcrafted cotton quilt.

If this is a room, surely there must be a light switch somewhere.

>feel light switch
You get off the bed, grope for a light switch along the wall. Your finger touches a metal switch, this must be it.

>flip light
As soon as you hit the switch, glorious radiance pours down from the ceiling light, filling the room and forcing the darkness to recede. For a moment you have to squeeze your eyes to adapt the sudden change.

Cabin
Spacious ship cabin for a single sailor. The only thing that deviates from the overall pragmatic design is the refined wooden plate floor. There's a single porthole window on the plain steel wall, its rim is a little bit rusty. Despite scattered scratches, bulges, wear and tear on the wall, the cabin withstood the vicissitudes of time.

You can see a steel door that is locked under a combination padlock, a table on which is a few paper, a bed, a bookshelf in which are some books, a wardrobe in which is a leather coat, a closet in which is a few cups, a desk with a drawer on which is a picture and a porthole window.

You are still quite confused about the situation, but you somehow feel a sense of urgency. Anyway, you need to get out of the room and find out what is this all about.

* * *

>stand up
You get off the bed.

It is pitch dark, and you can't see a thing.

>look
It is pitch dark, and you can't see a thing.

>get on the bed
That's not something you can enter.

>move to bed
That noun did not make sense in this context.

>go to bed
That noun did not make sense in this context.

>go bed
That's not something you can enter.

If this is a room, surely there must be a light switch somewhere.

>move bed
It is fixed in place.

>walk to bed
That noun did not make sense in this context.

>get on bed
That's not something you can enter.

>get in bed
That's not something you can enter.

>place player on bed
That's not a verb I recognise.

>put player on bed
You can't see any such thing.

>feel bed
You can feel the smooth linen bedsheet, a soft pillow. Nothing special about it, but lying in the bed makes you feel at ease.

>feel pillow
Bouncy feather pillow, soft and warm to the touch.

>smell
You can smell thin salt air, indicating sea nearby.

>hear
What do you want to hear?

* * *

>listen
All you can hear is the sound of silence.

>feel myself
Limbs? Check. Legs? Check. Head? Check. Eyes? Check. Apparently your eyes are fine, it's just that the room is too dark.

* * *

>stand up
You get off the bed.

It is pitch dark, and you can't see a thing.

>feel pillow
Bouncy feather pillow, soft and warm to the touch.

>feel quilt
Soft, handcrafted cotton quilt.

>feel bed
You can feel the smooth linen bedsheet, a soft pillow. Nothing special about it, but lying in the bed makes you feel at ease.

If this is a room, surely there must be a light switch somewhere.

>feel for light switch
It is pitch dark, and you can't see a thing.

You get off the bed, grope for a light switch along the wall. Your finger touches a metal switch, this must be it.

>look
It is pitch dark, and you can't see a thing.

>flip switch
It is pitch dark, and you can't see a thing.

As soon as you hit the switch, glorious radiance pours down from the ceiling light, filling the room and forcing the darkness to recede. For a moment you have to squeeze your eyes to adapt the sudden change.

Cabin
Spacious ship cabin for a single sailor. The only thing that deviates from the overall pragmatic design is the refined wooden plate floor. There's a single porthole window on the plain steel wall, its rim is a little bit rusty. Despite scattered scratches, bulges, wear and tear on the wall, the cabin withstood the vicissitudes of time.

You can see a steel door that is locked under a combination padlock, a table on which is a few paper, a bed, a bookshelf in which are some books, a wardrobe in which is a leather coat, a closet in which is a few cups, a desk with a drawer on which is a picture and a porthole window.

You are still quite confused about the situation, but you somehow feel a sense of urgency. Anyway, you need to get out of the room and find out what is this all about.

* * *

>get up
You get off the bed.

lul

>stand up
But you aren't in anything at the moment.

>undo
[Previous turn undone.]

>undo
Total Darkness
[Previous turn undone.]

>stand up
You get off the bed.

It is pitch dark, and you can't see a thing.

>check below pillow
You can't see any such thing.

>check pillow
Bouncy feather pillow, soft and warm to the touch.

* * *

>get up
You get off the bed.

lul

>look
lul

>look around
You can't see any such thing.

* * *

>check myself
Limbs? Check. Legs? Check. Head? Check. Eyes? Check. Apparently your eyes are fine, it's just that the room is too dark.

* * *

>feel for the light switch
Total Darkness
It is pitch dark, and you can't see a thing.

You get off the bed, grope for a light switch along the wall. Your finger touches a metal switch, this must be it.

>flip light
As soon as you hit the switch, glorious radiance pours down from the ceiling light, filling the room and forcing the darkness to recede. For a moment you have to squeeze your eyes to adapt the sudden change.

Cabin
Spacious ship cabin for a single sailor. The only thing that deviates from the overall pragmatic design is the refined wooden plate floor. There's a single porthole window on the plain steel wall, its rim is a little bit rusty. Despite scattered scratches, bulges, wear and tear on the wall, the cabin withstood the vicissitudes of time.

You can see a steel door that is locked under a combination padlock, a table on which is a few paper, a bed, a bookshelf in which are some books, a wardrobe in which is a leather coat, a closet in which is a few cups, a desk with a drawer on which is a picture and a porthole window.

You are still quite confused about the situation, but you somehow feel a sense of urgency. Anyway, you need to get out of the room and find out what is this all about.

* * *

>feel quilt
Soft, handcrafted cotton quilt.

>feel bed
You can feel the smooth linen bedsheet, a soft pillow. Nothing special about it, but lying in the bed makes you feel at ease.

>feel myself
Limbs? Check. Legs? Check. Head? Check. Eyes? Check. Apparently your eyes are fine, it's just that the room is too dark.

>feel wall
You can't see any such thing.

>feel the wall
You can't see any such thing.

>feel bed
You can feel the smooth linen bedsheet, a soft pillow. Nothing special about it, but lying in the bed makes you feel at ease.

If this is a room, surely there must be a light switch somewhere.

>feel light switch
It is pitch dark, and you can't see a thing.

You get off the bed, grope for a light switch along the wall. Your finger touches a metal switch, this must be it.

>flip switch
As soon as you hit the switch, glorious radiance pours down from the ceiling light, filling the room and forcing the darkness to recede. For a moment you are almost blinded by it.

Cabin
Spacious ship cabin for a single sailor. The only thing that deviates from the overall pragmatic design is the refined wooden plate floor. There's a single porthole window on the plain steel wall, its rim is a little bit rusty. Despite scattered scratches, bulges, wear and tear on the wall, the cabin withstood the vicissitudes of time.

You can see a steel door that is locked under a combination padlock, a table on which is a few paper, a bed, a bookshelf in which are some books, a wardrobe in which is a leather coat, a closet in which is a few cups, a desk with a drawer on which is a picture and a porthole window.

You are still quite confused about the situation, but you somehow feel a sense of urgency. Anyway, you need to get out of the room and find out what is this all about.

* * *

>feel switch
You get off the bed, grope for any protrusion along the wall. Your finger touches a small metal lever, this must be it!

>flip switch
It is pitch dark, and you can't see a thing.

As soon as you hit the switch, glorious radiance pours down from the ceiling light, filling the room and forcing the darkness to recede. For a moment you are almost blinded by it.

Cabin
Spacious ship cabin for a single sailor. The only thing that deviates from the overall pragmatic design is the refined wooden plate floor. There's a single porthole window on the plain steel wall, its rim is a little bit rusty. Despite scattered scratches, bulges, wear and tear on the wall, the cabin withstood the vicissitudes of time.

You can see a steel door that is locked under a combination padlock, a table on which is a few paper, a bed, a bookshelf in which are some books, a wardrobe in which is a leather coat, a closet in which is a few cups, a desk with a drawer on which is a picture and a porthole window.

You are still quite confused about the situation, but you somehow feel a sense of urgency. Anyway, you need to get out of the room and find out what is this all about.

* * *

>feel switch
You get off the bed, grope for any protrusion along the wall. Your finger touches a small metal lever, this must be it!

>flip metal lever
As soon as you hit the switch, glorious radiance pours down from the ceiling light, filling the room and forcing the darkness to recede. For a moment you are almost blinded by it.

Cabin
Spacious ship cabin for a single sailor. The only thing that deviates from the overall pragmatic design is the refined wooden plate floor. There's a single porthole window on the plain steel wall, its rim is a little bit rusty. Despite scattered scratches, bulges, wear and tear on the wall, the cabin withstood the vicissitudes of time.

You can see a steel door that is locked under a combination padlock, a table on which is a few paper, a bed, a bookshelf in which are some books, a wardrobe in which is a leather coat, a closet in which is a few cups, a desk with a built-in drawer. On the desk is a picture decorated inside a frame.

You are still quite confused about the situation, but you somehow feel a sense of urgency, as if something bad is about to happen. Anyway, you need to get out of the room and find out what this is all about.

>look window
A single porthole window full of small scratches, the rim is a bit rusty. You cannot see anything through it, it's pitch black outside - you can't even see a single star nor the moon. Even though the diameter could technically allow a person to crawl through, the window itself is not designed to be opened.

>look desk
A nice sturdy wooden desk. A built-in drawer with a keyhole is below its working surface.

On the desk is a wedding picture.

>look
Cabin
Spacious ship cabin for a single sailor. The only thing that deviates from the overall pragmatic design is the refined wooden plate floor. There's a single porthole window on the plain steel wall, its rim is a little bit rusty. Despite scattered scratches, bulges, wear and tear on the wall, the cabin withstood the vicissitudes of time.

You can see a steel door that is locked under a combination padlock, a table on which is a few paper, a bed, a bookshelf in which are some books, a wardrobe in which is a leather coat, a closet in which is a few cups, a desk with a built-in drawer. On the desk is a picture decorated inside a frame.

>look padlock
Bulky combination padlock with 4 digits, apparently someone put it on there, but who?

>look door
This is just a typical steel door on a military vessel - heavy and sturdy. You notice there is an old padlock on the hasp. If you want to go out, you'll definitely need to get rid of this padlock.

* * *

>feel the wall
You feel nothing unexpected.

* * *

>touch wall
Your hand touches the cold steel wall near the bed, your finger tip sweeps across the wall surface, it is coarse and unfriendly, yet you feel a strange sense of affinity that you cannot quite explain.

>touch wall
Your hand touches the cold steel wall. you can feel the slight vibration repeating sporadically, some kind of giant machine is running somewhere near.

>touch wall
Your hand touches the cold steel wall. you can feel the slight vibration repeating sporadically, some kind of giant machine is running somewhere near.

>touch wall
Your hand touches the cold steel wall. you can feel the slight vibration repeating sporadically, some kind of giant machine is running somewhere near.

If this is a room, surely there must be a light switch somewhere.

* * *

>touch wall
Your hand touches the cold steel wall near the bed, your finger tip sweeps across the wall surface, it is coarse and unfriendly, yet you feel a strange sense of affinity that you cannot quite explain.

>flip light
It is pitch dark, and you can't see a thing.

As soon as you hit the switch, glorious radiance pours down from the ceiling light, filling the room and forcing the darkness to recede. For a moment you are almost blinded by it.

Cabin
Spacious ship cabin for a single sailor. The only thing that deviates from the overall pragmatic design is the refined wooden plate floor. There's a single porthole window on the plain steel wall, its rim is a little bit rusty. Despite scattered scratches, bulges, wear and tear on the wall, the cabin withstood the vicissitudes of time.

You can see a steel door that is locked under a combination padlock, a table on which is a few paper, a bed, a bookshelf in which are some books, a wardrobe in which is a leather coat, a closet in which is a few cups, a desk with a drawer on which is a picture and a porthole window.

You are still quite confused about the situation, but you somehow feel a sense of urgency. Anyway, you need to get out of the room and find out what is this all about.

>look window
A single porthole window full of small scratches, the rim is a bit rusty. You cannot see anything through it, it's pitch black outside. Even though the diameter could fit a person, it is not designed to be opened.

>look outside
You see nothing unexpected in that direction.

* * *

>check under pillow
It is pitch dark, and you can't see a thing.

>check pillow
Bouncy feather pillow, soft and warm to the touch.

>check below
You can't see any such thing.

>check under pillow
It is pitch dark, and you can't see a thing.

>check under bed
It is pitch dark, and you can't see a thing.

If this is a room, surely there must be a light switch somewhere.

>feel wall
Your hand touches the cold steel wall near the bed, your finger tip sweeps across the wall surface, it is coarse and unfriendly, yet you feel a strange sense of affinity that you cannot quite explain.

>feel light switch
You get off the bed, grope for a light switch along the wall. Your finger touches a metal switch, this must be it.

It is pitch dark, and you can't see a thing.

>undo
Total Darkness
[Previous turn undone.]

>feel light switch
You get off the bed, grope for a light switch along the wall. Your finger touches a metal switch, this must be it.

It is pitch dark, and you can't see a thing.

* * *

>feel for switch
You get off the bed, grope for a light switch along the wall. Your finger touches a metal switch, this must be it.

>undo
Total Darkness
[Previous turn undone.]

>stand
You get off the bed.

It's pitch black, and you can't see a thing.

>feel for switch
You grope for a light switch along the wall. Your finger touches a metal switch, this must be it.

>flip switch
As soon as you hit the switch, glorious radiance pours down from the ceiling light, filling the room and forcing the darkness to recede. For a moment you are almost blinded by it.

Cabin
Spacious ship cabin for a single sailor. The only thing that deviates from the overall pragmatic design is the refined wooden plate floor. There's a single porthole window on the plain steel wall, its rim is a little bit rusty. Despite scattered scratches, bulges, wear and tear on the wall, the cabin withstood the vicissitudes of time.

You can see a steel door that is locked under a combination padlock, a table on which is a few paper, a bed, a bookshelf in which are some books, a wardrobe in which is a leather coat, a closet in which is a few cups, a desk with a built-in drawer. On the desk is a picture decorated inside a frame.

You are still quite confused about the situation, but you somehow feel a sense of urgency, as if something bad is about to happen. Anyway, you need to get out of the room and find out what this is all about.

>look out
You see nothing unexpected in that direction.

>look out window
I only understood you as far as wanting to look outside.

>look window
A single porthole window full of small scratches, the rim is a bit rusty. You cannot see anything through it because it's pitch black outside. Even though the diameter could fit a person, it is not designed to be opened.

* * *

I beg your pardon?

* * *

>look
Total Darkness
You can't even see your hands!

>look
Total Darkness
You can't even see your hands!

If this is a room, surely there must be a light switch somewhere.

* * *

I beg your pardon?

>smell
You can smell thin salt air, indicating sea nearby.

>smell
You can smell thin salt air, indicating sea nearby.

lol

>smell
You can smell thin salt air, indicating sea nearby.

lol

* * *

>test a
(Testing.)

>[1] switch on light switch

It's pitch black, and you can't see a thing.

As soon as you hit the switch, glorious radiance pours down from the ceiling light, filling the room and forcing the darkness to recede. For a moment you are almost blinded by it.

Cabin
Spacious ship cabin for a single sailor. The only thing that deviates from the overall pragmatic design is the refined wooden plate floor. There's a single porthole window on the plain steel wall, its rim is a little bit rusty. Despite scattered scratches, bulges, wear and tear on the wall, the cabin withstood the vicissitudes of time.

You can see a steel door that is locked under a combination padlock, a table on which is a few paper, a bed, a bookshelf in which are some books, a wardrobe in which is a leather coat, a closet in which is a few cups, a desk with a built-in drawer. On the desk is a picture decorated inside a frame.

You are still quite confused about the situation, but you somehow feel a sense of urgency, as if something bad is about to happen. Anyway, you need to get out of the room and find out what this is all about.

>[2] examine steel door
This is just a typical steel door on a military vessel - heavy and sturdy. You notice there is an old padlock on the hasp. If you want to go out, you'll definitely need to get rid of this padlock.

>[3] open steel door
You cannot force open the door while there's a sturdy padlock holding it in place.

>[4] look under bed
You find the brass key!

>[5] unlock drawer
(with the brass key)
You unlock the drawer.

>[6] open drawer
You open the drawer, revealing a revolver pistol.

>[7] take pistol
An antique revolver pistol lies silently in the drawer. The revolver is a Webley Mk. IV revolver, a memorial medal for a war veteran of a not so distant war.
The moment you see it, you feel something is awakening deep inside your memory, you seem to recall a certain passcode - 9724.

You take the pistol and instinctly hit the break lever, flip the fore-piece forward and look into the cylinder to check how many bullets are left. To your disappointment, it seems there is only one .455 bullet left in the cylinder.

>look bookshelf
A fairly large metallic bookshelf fixed to the wall and ceiling. It is filled with all kinds of books - "How to Avoid Huge Ships, Beyond Good & Evil, Strange Creatures at Sea.". 

In the bookshelf are some books.

>close drawer
You close the drawer.

>open drawer
You open the drawer.

>check pistol
A Webley Mk. IV .455 revolver pistol.

>investigate pistol
A Webley Mk. IV .455 revolver pistol.

>dial the padlock to 4555
You turn the dial, but nothing happens.

>check under pillow
You find nothing of interest.

>restart
Are you sure you want to restart?

>y
The Ghost Ship
An Interactive Fiction by "Zonghan Guowang" Release along with a website
Release 1 / Serial number 211118 / Inform 7 build 6M62 (I6/v6.33 lib 6/12N) SD

Total Darkness
You wake up, from an unbearable headache, it is as if you've been through a terrible nightmare. But what is worse is that you seem to have lost a large portion of your memory. It is a strange feeling - names, languages and general knowledge, of these you know still, but you can't remember the most important things at this moment - where the hell are you. 

You open your eyes as the acute headache subsides but you can't see anything. It is the most overwhelming darkness ever - it was not merely the darkness that came out of absence of light, it was much more sinister, almost as if something behind the darkness is watching your every move. You stretch your eyes as wide as possible trying to capture the even dimmest glimmer of light but still nothing but blackness.

You are certain that you're in some kind of a room, the quiet and stale air gives away. Even though you cannot see anything, your other four senses are alright - you feel the pillow beneath your head and the soft, warm quilt over your body.

>check under pillow
It is pitch dark, and you can't see a thing.

>look under pillow
It is pitch dark, and you can't see a thing.

>search under pillow
It is pitch dark, and you can't see a thing.

>check light switch
It is pitch dark, and you can't see a thing.

If this is a room, surely there must be a light switch somewhere.

>feel light switch
You get off the bed, grope for any protrusion along the wall. Your finger touches a small metal lever, this must be it!

>flip light on
You can't see any such thing.

>switch light
As soon as you hit the switch, glorious radiance pours down from the ceiling light, filling the room and forcing the darkness to recede. For a moment you are almost blinded by it.

Cabin
Spacious ship cabin for a single sailor. The only thing that deviates from the overall pragmatic design is the refined wooden plate floor. There's a single porthole window on the plain steel wall, its rim is a little bit rusty. Despite scattered scratches, bulges, wear and tear on the wall, the cabin withstood the vicissitudes of time.

You can see a steel door that is locked under a combination padlock, a table on which is a few paper, a bed, a bookshelf in which are some books, a wardrobe in which is a leather coat, a closet in which is a few cups, a desk with a built-in drawer. On the desk is a picture decorated inside a frame.

You are still quite confused about the situation, but you somehow feel a sense of urgency, as if something bad is about to happen. Anyway, you need to get out of the room and find out what this is all about.

>look light switch
TODO - light switch 

The light switch is currently switched on.

>look wardrobe
TODO - Wardrobe 

In the wardrobe is a leather coat.

>wear coat
(first taking the leather coat)
You now have more pockets to store items.

>smell the air
You can't see any such thing.

>smell
You can smell thin salt air, indicating sea nearby.

* * *

>smell the air
You can smell thin salt air, indicating sea nearby.

>smell the room
You can't see any such thing.

>listen
You hear nothing unexpected.

>hear
What do you want to hear?

>listen wall
I only understood you as far as wanting to listen.

>test a
(Testing.)

>[1] switch on light switch

It's pitch black, and you can't see a thing.

As soon as you hit the switch, glorious radiance pours down from the ceiling light, filling the room and forcing the darkness to recede. For a moment you are almost blinded by it.

Cabin
Spacious ship cabin for a single sailor. The only thing that deviates from the overall pragmatic design is the refined wooden plate floor. There's a single porthole window on the plain steel wall, its rim is a little bit rusty. Despite scattered scratches, bulges, wear and tear on the wall, the cabin withstood the vicissitudes of time.

You can see a steel door that is locked under a combination padlock, a table on which is a few paper, a bed, a bookshelf in which are some books, a wardrobe in which is a leather coat, a closet in which is a few cups, a desk with a built-in drawer. On the desk is a picture decorated inside a frame.

You are still quite confused about the situation, but you somehow feel a sense of urgency, as if something bad is about to happen. Anyway, you need to get out of the room and find out what this is all about.

>[2] examine steel door
This is just a typical steel door on a military vessel - heavy and sturdy. You notice there is an old padlock on the hasp. If you want to go out, you'll definitely need to get rid of this padlock.

>[3] open steel door
You cannot force open the door while there's a sturdy padlock holding it in place.

>[4] look under bed
You find the brass key!

>[5] unlock drawer
(with the brass key)
You unlock the drawer.

>[6] open drawer
You open the drawer, revealing a revolver pistol.

>[7] take pistol
An antique revolver pistol lies silently in the drawer. The revolver is a Webley Mk. IV revolver, a memorial medal for a war veteran of a not so distant war.
The moment you see it, you feel something is awakening deep inside your memory, you seem to recall a certain passcode - 3413.

You take the pistol and instinctly hit the break lever, flip the fore-piece forward and look into the cylinder to check how many bullets are left. To your disappointment, it seems there is only one .455 bullet left in the cylinder.

>listen
You can hear faint hummings of electricity.

* * *

>try to smell
(ignoring the unnecessary words "try to")

You get a sniff of a greasy smell, you must be lying on this pillow for quite some time.

>try to stand up
(ignoring the unnecessary words "try to")

You get off the bed.

It's pitch black, and you can't see a thing.

* * *

>smell pillow with nose
(ignoring the unnecessary words "with nose")

You get a sniff of a greasy smell, you must be lying on this pillow for quite some time.

* * *

>find switch
That's not a verb I recognise.